propos : PROPOSe
agaisnt : AGAInsT
prpose : PRoPOSE
proposs :PROPOSe 
yuo : you
peac : PEACe
pace : PeACE
aliance : AlLIANCE
alli : ALLy
allianc : alliance
watn : want
Peace : peace
alcancar : alcan�ar
alcatrao : alcatr�o
alem : al�m
alemao : alem�o
alfabetica : alfab�tica
Alianca : Alian�a
almoco : almo�o
Almoco : Almo�o
Alvaro : �lvaro
ambiguos : amb�guos
ambito : �mbito
AMBULANCIAS : AMBUL�NCIAS
ameacadas : amea�adas
AMESTERDAO : AMESTERD�O
analogico : anal�gico
analogicos : anal�gicos
Analogicos : Anal�gicos
Angelo : �ngelo
anonimo : an�nimo
antecedencia : anteced�ncia
anteveem : antev�em
anti-democratico : anti-democr�tico
Antonio : Ant�nio
Anuncios : An�ncios
APERFEICOAMENTO : APERFEI�OAMENTO
aplicavel : aplic�vel
apos : ap�s
Apos : Ap�s
Araujo : Ara�jo
Aritmetica : Aritm�tica
aritmeticas : aritm�tica
armazem : armaz�m
Artistica : Art�stica
ASSISTENCIA : ASSIST�NCIA
Assistencia : Assist�ncia
ATMOSFERICAS : ATMOSF�RICAS
atras : atr�s
atraves : atrav�s
Atraves : Atrav�s
atrio : �trio
Auditorio : Audit�rio
ausencia : aus�ncia
AUSTRIA : �USTRIA
automatica : autom�tica
Automatica : Autom�tica
automatico : autom�tico
Automaticos : Autom�ticos
AUTOMOVEL : AUTOM�VEL
AUTONOMA : AUTONOMIA
avanca : avan�a
avancada : avan�ada
Avancada : Avan�ada
AVANCADAS : AVAN�ADAS
Avancadas : Avan�adas
Avancados : Avan�ados
avancai : avan�ai
avancar : avan�ar
avioes : avi�es
baixissimos : baix�ssimos
balanco : balan�o
balcaozinho : balc�ozinho
bancario : banc�rio
basicas : b�sicas
basicos : b�sicos
beneficiarios : benefici�rios
bibliografica : bibliogr�fica
BIBLIOGRAFICA : BIBLIOGR�FICA
Bibliotecarios : Bibliotec�rios
binaria : bin�ria
binario : bin�rio
binarios : bin�rios
Biodinamica : Biodin�mica
bionica : bi�nica
botoes : bot�es
BULGARIA : BULG�RIA
burocratica : burocr�tica
cabeca : cabe�a
Cabecalho : Cabe�alho
cafe : caf�
Cafe : Caf�
calendario : calend�rio
California : Calif�rnia
camara : c�mara
camaras : c�maras
Candida : C�ndida
Candido : c�ndido
Capitao : Capit�o
CAPITULO : CAP�TULO
caracteristica : caracter�stica
caracteristicas : caracter�sticas
caracteristico : caracter�stico
cartao : cart�o
Cartao : Cart�o
cartao-dourado : cart�o-dourado
CARTOES : CART�ES
catalogos : cat�logos
catastrofe : cat�strofe
Categorica : Categ�rica
Categoricos : Categ�ricos
Catolica : Cat�lica
CELULAS : C�LULAS
cenarios : cen�rios
ceptica : c�ptica
Cesario : Ces�rio
chao : ch�o
chavena : ch�vena
Chegariamos : Chegar�amos
Cidalia : Cid�lia
Ciencia : Ci�ncia
Ciencias : Ci�ncias
Claudia : Cl�udia
clausula : cl�usula
Climaco : Cl�maco
codigo : c�digo
Codigo : C�digo
codigos : c�digos
coerencia : coer�ncia
Colegio : Col�gio
Colegios : Col�gios
Combinatoria : Combinat�ria
combustiveis : combust�veis
comeca : come�a
comecam : come�am
comecando : come�ando
comecar : come�ar
comecaram : come�aram
comecassem : come�assem
comeco : come�o
comecou : come�ou
COMENTARIO : COMENT�RIO
comentarios : coment�rios
Comentarios : Coment�rios
Comissao : Comiss�o
comissoes : comiss�es
Comissoes : Comiss�es
COMITE : COMIT�
compativeis : compat�veis
compativel : compat�vel
competencia : compet�ncia
Competencia : Compet�ncia
Competencias : Compet�ncias
compressao : compress�o
Comunica�ao : Comunica��o
Comunitarias : Comunit�rias
comunitario : comunit�rio
Comunitario : Comunit�rio
comunitarios : comunit�rios
concessao : concess�o
concessionario : concession�rio
Conclusao : Conclus�o
conclusoes : conclus�es
concorrencia : concorr�ncia
confianca : confian�a
configura�ao : configura��o
confirma�ao : confirma��o
confortavel : confort�vel
confusao : confus�o
confusoes : confus�es
consequencia : consequ�ncia
consequencias : consequ�ncias
consumiveis : consum�veis
contabilisticas : contabil�sticas
contabilisticos : contabil�sticos
contabiliza�ao : contabiliza��o
conteudo : conte�do
continuos : cont�nuos
controlavel : control�vel
conveniencia : conveni�ncia
CONVENIO : CONV�NIO
CONVIVIO : CONV�VIO
convivios : conv�vios
convocatoria : convocat�ria
coronarias : coron�rias
correspondencia : correspond�ncia
Credencia�ao : Credencia��o
crianca : crian�a
criptografica : criptogr�fica
criterio : crit�rio
criterios : crit�rios
cronicas : cr�nicas
cronicos : cr�nicos
Curriculo : Curr�culo
dao : d�o
Dao-se : D�o-se
debeis : d�beis
Decada : D�cada
DECISAO : DECIS�O
Decisao : Decis�o
Decisoes : Decis�es
deem : d�em
deem-me : d�em-me
deem-nos : d�em-nos
DEFICIENCIA : DEFICI�NCIA
deficiencias : defici�ncias
democratico : democr�tico
demorarao : demorar�o
depressao : depress�o
descri�ao : descri��o
desgracadinhos : desgra�adinhos
desperdicado : desperdi�ado
desperdicios : desperd�cios
destinatario : destinat�rio
destinatarios : destinat�rios
detras : detr�s
deverao : dever�o
diagonosticos : diagn�stico
diario : di�rio
Diario : Di�rio
dicionario : dicion�rio
Dicionarios : Dicion�rios
diferenca : diferen�a
dificeis : dif�ceis
dificil : dif�cil
difusao : difus�o
dimensao : dimens�o
dimensoes : dimens�es
dinamarques : dinamarqu�s
dinamica : din�mica
dinamicas : din�micas
dinamicos : din�micos
directorio : direct�rio
dirigir-se-ao : dirigir-se-�o
discordancia : discord�ncia
discussao : discuss�o
discussoes : discuss�es
discutivel : discut�vel
dispoe : disp�e
dispoem : disp�em
disponibilizarao : disponibilizar�o
disponiveis : dispon�veis
disponivel : dispon�vel
divergencia : diverg�ncia
divergencias : diverg�ncias
diversao : divers�o
divisao : divis�o
divisiveis : divis�veis
divisoes : divis�es
docencia : doc�ncia
dominio : dom�nio
dominios : dom�nios
Dominios : Dom�nios
dominios : dom�nios
DOMOTICA : DOM�TICA
domoticos : dom�ticos
dura�ao : dura��o
duzia : d�zia
Ecologica : Ecol�gica
ecologicas : ecol�gicas
ecologico : ecol�gico
economica : econ�mica
economicas : econ�micas
economico : econ�mico
economicos : econ�micos
Edificio : Edif�cio
edificio : edif�cio
EDIFICIOS : EDIF�CIOS
edificios : edif�cios
eficacia : efic�cia
eficiencia : efici�ncia
electrao : electr�o
electrica : el�ctrica
electrico : el�ctrico
electricos : el�ctricos
Electricos : El�ctricos
electroes : electr�es
electromagnetica : electromagn�tica
electromagneticas : electromagn�ticas
Electronica : Electr�nica
electronica : electr�nica
electronicas : electr�nicas
electronico : electr�nico
ELECTRONICOS : ELECTR�NICOS
electronicos : electr�nicos
electrotecnica : electrot�cnica
elegiveis : eleg�veis
elegivel : eleg�vel
Embriao : Embri�o
emergencia : emerg�ncia
emergencias : emerg�ncias
Emilia : Em�lia
Emissao : Emiss�o
emissao : emiss�o
emissoes : emiss�es
EMPRESARIOS : EMPRES�RIOS
emprestimo : empr�stimo
empurrao : empurr�o
enciclopedia : enciclop�dia
encontrarao : encontrar�o
enderecado : endere�ado
endereco : endere�o
enderecos : endere�os
energetica : energ�tica
energeticas : energ�ticas
energetico : energ�tico
energeticos : energ�ticos
enfase : �nfase
enquadrar-se-ao : enquadrar-se-�o
entao : ent�o
entrarao : entrar�o
entropico : entr�pico
envidracada : envidra�ada
involucros : inv�lucros
epoca : �poca
epocas : �pocas
esboco : esbo�o
escalao : escal�o
escandalo : esc�ndalo
escritorio : escrit�rio
Escritorios : Escrit�rios
escrutinio : escrut�nio
esferograficas : esferogr�ficas
esforco : esfor�o
esforcos : esfor�os
espacamento : espa�amento
espaco : espa�o
espacos : espa�os
especie : esp�cie
Especies : Esp�cies
especificos : espec�ficos
espectaculo : espect�culo
esperanca : esperan�a
Esquematicos : Esquem�ticos
Esta�ao : Esta��o    
esta�oes : esta��es   
Estadio : Est�dio
estadio : est�dio
estagiario : estagi�rio
estagiarios : estagi�rios
estagios : est�gios
estao : est�o
estara : estar�
estarao : estar�o
estatica : est�tica
estatico : est�tico
estaticos : est�ticos
estatistica : estat�stica
estatisticas : estat�sticas
Estatisticas : Estat�sticas
estatistico : estat�stico
estatisticos : estat�sticos
estatutarios : estatut�rios
estavamos : est�vamos
estavel : est�vel
Estefania : Estef�nia
estereis : est�reis
esteticos : est�ticos
Estilisticos : Estil�sticos
ESTRATEGIA : ESTRAT�GIA
estrategia : estrat�gia
estrategias : estrat�gias
estrategica : estrat�gica
estrategicas : estrat�gicas
estrategico : estrat�gico
estrategicos : estrat�gicos
estudio : est�dio
estudios : est�dios
Estudios : Est�dios
etica : �tica
eticos : �ticos
evolucionarios : evolucion�rios
ex-Uniao : ex-Uni�o
excelencia : excel�ncia
exclusao : exclus�o
execu�ao : execu��o
executaveis : execut�veis
executavel : execut�vel
exercicio : exerc�cio
exigencia : exig�ncia
exigencias : exig�ncias
existencia : exist�ncia
existirao : existir�o
exito : �xito
exoticas : ex�ticas
expansao : expans�o
expansivel : expans�vel
experiencia : experi�ncia
Experiencias : Experi�ncias
experiencias : experi�ncias
explicac�es : explica��es
explicitos : expl�citos
exploratorias : explorat�rias
explosao : explos�o
expressao : express�o
expressoes : express�es
extensao : extens�o
extensoes : extens�es
Extraordinaria : Extraordin�ria
Extraordinarias : Extraordin�rias
faca-me : fa�a-me
faca-o : fa�a-o
facam : fa�am
facam-no : fa�am-no
faceis : f�ceis
facil : f�cil
Faco : Fa�o
faco : fa�o
Falcao : Falc�o
familia : fam�lia
familias : fam�lias
fantastico : fant�stico
far-se-a : far-se-�
farao : far�o
fatidico : fat�dico
Fatima : F�tima
favoravel : favor�vel
femea : f�mea
fenomeno : fen�meno
ferroviario : ferrovi�rio
fiavel : fi�vel
ficarao : ficar�o
ficticio : fict�cio
filosofica : filos�fica
Financas : Finan�as
finlandes : finland�s
FINLANDIA : FINL�NDIA
Finlandia : Finl�ndia
fisica : f�sica
Fisica : F�sica
fisicas : f�sicas
flexiveis : flex�veis
flexivel : flex�vel
fonetica : fon�tica
forcosamente : for�osamente
FORMA�AO : FORMA��O
formula�ao : formula��o
formulario : formul�rio
formularios : formul�rios
fotografico : fotogr�fico
Frances : Franc�s
frances : franc�s
frenetica : fren�tica
FRENETICA : FREN�TICA
frequencia : frequ�ncia
frequencias : frequ�ncias
funcionario : funcion�rio
funcionarios : funcion�rios
funcionarios : funcion�rios
func�es : fun��es
fusao : fus�o
generica : gen�rica
generico : gen�rico
genericos : gen�ricos
genero : g�nero
genetica : gen�tica
Geneticos : Gen�ticos
geografica : geogr�fica
geopoliticas : geopol�ticas
gerencia : ger�ncia
GESTAO : GEST�O
gestao : gest�o
glossario : gloss�rio
Goncalo : Gon�alo
Goncalves : Gon�alves
gostariamos : gostar�amos
Graca : Gra�a
gracas : gra�as
Grafica : Gr�fica
grafica : gr�fica
graficas : gr�ficas
GRAFICOS : GR�FICOS
graficos : gr�ficos
gratidao : gratid�o
guiao : gui�o
havera : haver�
heterogeneo : heterog�neo
hidrico : h�drico
Hidricos : H�dricos
hidro-termicos : hidro-t�rmicos
hierarquico : hier�rquico
hierarquicos : hier�rquicos
hipocritas : hip�critas
hipotese : hip�tese
hipoteses : hip�teses
historicas : hist�ricas
historico : hist�rico
Horacio : Hor�cio
horario : hor�rio
horriveis : horr�veis
horrivel : horr�vel
iberica : ib�rica
identico : id�ntico
ideologos : ide�logos
ignorancia : ignor�ncia
ilegivel : ileg�vel
Iliquido : Il�quido
ilusao : ilus�o
imobiliaria : imobili�ria
Imobiliarias : Imobili�rias
imobiliarios : imobili�rios
imoveis : im�veis
implica�oes : implica��es
Implicita : Impl�cita
implicito : impl�cito
importancia : import�ncia
importantissima : important�ssima
impossivel : imposs�vel
impraticavel : impratic�vel
imprescindivel : imprescind�vel
impressao : impress�o
impressoes : impress�es
impronunciavel : impronunci�vel
inaceitavel : inaceit�vel
inacessivel : inacess�vel
inadiaveis : inadi�veis
inadmissivel : inadmiss�vel
INCENDIOS : INC�NDIOS
incendios : inc�ndios
incidencia : incid�ncia
inclusao : inclus�o
incognita : inc�gnita
inconsistencias : inconsist�ncias
Inconsolaveis : Inconsol�veis
incontivel : incont�vel
inconveniencias : inconveni�ncias
incrivel : incr�vel
independencia : independ�ncia
INDIA : �NDIA
indica�oes : indica��es
indice : �ndice
indices : �ndices
indiscutivel : indiscut�vel
indispensaveis : indispens�veis
indisponiveis : indispon�veis
indisponivel : indispon�vel
individuos : indiv�duos
indole : �ndole
inedito : in�dito
ineficacia : inefic�cia
inerencia : iner�ncia
inevitavel : inevit�vel
infindavel : infind�vel
inflexao : inflex�o
informa�ao : informa��o
Informatica : Inform�tica
informaticas : inform�ticas
INFORMATICO : INFORM�TICO
informatico : inform�tico
informaticos : inform�ticos
infrutiferas : infrut�feras
ingenua : ing�nua
Ingenuo : Ing�nuo
ingenuos : ing�nuos
ingles : ingl�s
ininteligiveis : inintelig�veis
inova�oes : inova��es
inoxidaveis : inoxid�veis
inquerito : inqu�rito
inqueritos : inqu�ritos
insatisfatoria : insatisfat�ria
insensiveis : insens�veis
instala�oes : instala��es
institui�ao : institui��o
insuficiencia : insufici�ncia
insuflavel : insufl�vel
insuperaveis : insuper�veis
insustentavel : insustent�vel
integravel : integr�vel
inteligencia : intelig�ncia
Inteligencia : Intelig�ncia
inten�oes : inten��es
interac�ao : interac��o
intercambios : interc�mbios
interconexao : interconex�o
interferencia : interfer�ncia
interferencias : interfer�ncias
intermediario : intermedi�rio
interminaveis : intermin�veis
interrup�oes : interrup��es
intervirao : intervir�o
intraduzivel : intraduz�vel
intrinsecos : intr�nsecos
introdu�ao : introdu��o
introdutoria : introdut�ria
inumeras : in�meras
inumeros : in�meros
invejavel : invej�vel
inviolaveis : inviol�veis
ionica : i�nica
irao : ir�o
iriamos : ir�amos
irrelevancia : irrelev�ncia
irreprimivel : irreprim�vel
irresponsaveis : irrespons�veis
italico : it�lico
ja : j�
japones : japon�s
Joao : Jo�o
Jose : Jos�
Julio : J�lio
junior : j�nior
juri : j�ri
juridica : jur�dica
juridico : jur�dico
juridicos : jur�dicos
justica : justi�a
laboratorio : laborat�rio
laboratorios : laborat�rios
lancada : lan�ada
LANCADO : LAN�ADO
lancados : lan�ados
lancam : lan�am
lancamento : lan�amento
lancamos : lan�amos
lancar : lan�ar
lanco : lan�o
lavatorios : lavat�rios
le-las : l�-las
le-lo : l�-lo
legiveis : leg�veis
Leitao : Leit�o
lexico : l�xico
licenca : licen�a
licencas : licen�as
lider : l�der
lideranca : lideran�a
liga�ao : liga��o
liga�oes : liga��es
lingua : l�ngua
linguas : l�nguas
linguistica : lingu�stica
linguisticos : lingu�sticos
literaria : liter�ria
Logicos : L�gicos
logistica : log�stica
Logistica : Log�stica
logistico : log�stico
Lourenco : Louren�o
louvavel : louv�vel
Luis : Lu�s
Lusiada : Lus�ada
macada : ma�ada
macrovisao : macrovis�o
mae : m�e
Magneticos : Magn�ticos
maioritarias : maiorit�rias
maioritario : maiorit�rio
maiuscula : mai�scula
maiusculas : mai�sculas
manfios : m�nfios
manuten�ao : manuten��o
mao : m�o
mao-de-obra : m�o-de-obra
maos : m�os
Mario : M�rio
mario : M�rio
maritima : mar�tima
Maritimas : Mar�timas
maritimo : mar�timo
maritimos : mar�timos
matematica : matem�tica
Matematicas : Matem�ticas
matematicos : matem�ticos
materia : mat�ria
materia-prima : mat�ria-prima
materias : mat�rias
maxima : m�xima
maximo : m�ximo
Mecanica : Mec�nica
mecanico : mec�nico
Mecanicos : Mec�nicos
mecanografico : mecanogr�fico
mediaticas : medi�ticas
medicos : m�dicos
medios : m�dios
Mediterranica : Mediterr�nica
Mendonca : Mendon�a
merito : m�rito
mes : m�s
metodo : m�todo
metodos : m�todos
metricas : m�tricas
metrologicos : metrol�gicos
MEXICO : M�XICO
Mexico : M�xico
Microelectronica : Microelectr�nica
milhoes : milh�es
mini-estudio : mini-est�dio
mini-estudios : mini-est�dios
minima : m�nima
minimas : m�nimas
minimo : m�nimo
minimos : m�nimos
Ministerio : Minist�rio
ministerio : minist�rio
Ministerios : Minist�rios
minusculas : min�sculas
Miscelanea : Miscel�nea
miseria : mis�ria
miseros : m�seros
missao : miss�o
misseis : m�sseis
missoes : miss�es
misterio : mist�rio
mobiliario : mobili�rio
MOCAMBIQUE : MO�AMBIQUE
mocos : mo�os
modulos : m�dulos
Monica : M�nica
mudanca : mudan�a
Mudancas : Mudan�as
mudancas : mudan�as
muitissimo : muit�ssimo
muito-sabios : muito-s�bios
multi-criterio : multi-crit�rio
multi-frequencia : multi-frequ�ncia
multidao : multid�o
Multimedia : Multim�dia
multimedia : multim�dia
multiplas : m�ltiplas
multiplos : m�ltiplos
nacoes : na��es
nao : n�o
nao-licenciados : n�o-licenciados
Nao-Linear : N�o-Linear
nao-sei-quantos : n�o-sei-quantos
natalicio : natal�cio
natalicios : natal�cios
necessaria : necess�ria
necessarias : necess�rias
necessario : necess�rio
necessarios : necess�rios
negocios : neg�cios
ninguem : ningu�m
Niveis : N�veis
niveis : n�veis
nivel : n�vel
noruegues : noruegu�s
notarios : not�rios
Nucleo : N�cleo
nucleo : n�cleo
Nucleos : N�cleos
nucleos : n�cleos
numerario : numer�rio
numerica : num�rica
numericos : num�ricos
numeros : n�meros
Obrigatorio : Obrigat�rio
obrigatorio : obrigat�rio
obstaculo : obst�culo
obten�ao : obten��o
ocasiao : ocasi�o
oceanograficos : oceanogr�ficos
ocorrencia : ocorr�ncia
oficios : of�cios
Ola : Ol�
opera�oes : opera��es
opiniao : opini�o
opinioes : opini�es
optica : �ptica
opticas : �pticas
Optico : �ptico
opticos : �pticos
optimo : �ptimo
OPTOELECTRONICA : OPTOELECTR�NICA
Optoelectronica : Optoelectr�nica
optoelectronicos : optoelectr�nicos
orcamentais : or�amentais
Orcamento : Or�amento
orcamento : or�amento
orcamentos : or�amentos
ordinaria : ordin�ria
orgao : org�o
orgaos : org�os
orgasmico : org�smico
ortografica : ortogr�fica
ortografico : ortogr�fico
Ortograficos : Ortogr�ficos
ouvir-se-ao : ouvir-se-�o
paciencia : paci�ncia
padrao : padr�o
Padroes : Padr�es
paes : p�es
paises : pa�ses
paixao : paix�o
panico : p�nico
panoramica : panor�mica
panoramico : panor�mico
pao : p�o
parabens : parab�ns
paradigmaticos : paradigm�ticos
paragrafos : par�grafos
Paraiso : Para�so
parametrizavel : parametriz�vel
parentesis : par�ntesis
parti�oes : parti��es
participarao : participar�o
parvoices : parvo�ces
passarao : passar�o
passivel : pass�vel
patrao : patr�o
patricos : p�tricos
patrimonio : patrim�nio
patrio : p�trio
patrios : p�trios
Pavilhao : Pavilh�o
pavilhao : pavilh�o
Pedagogica : Pedag�gica
pedagogico : pedag�gico
pedagogicos : pedag�gicos
peditorio : pedit�rio
pensoes : pens�es
perceptroes : perceptr�es
Perifericos : Perifericos
perifericos : perifericos
periodicas : periodicas
periodico : periodico
periodicos : periodicos
periodo : periodo
periodos : periodos
persistencia : persistencia
plastico : plastico
plenario : plenario
PODERA : PODER�
poderao : poder�o
poderiamos : poder�amos
poe : p�e
poem : p�em
polemica : pol�mica
Policromatico : Policrom�tico
Politecnica : Polit�cnica
politicos : pol�ticos
POLONIA : POL�NIA
poluicao : polui��o
ponderacoes : pondera��es
Pontapes : Pontap�s
porta-avioes : porta-avi�es
portateis : port�teis
portatil : port�til
portugues : portugu�s
Pos-Doutoramento : P�s-Doutoramento
pos-doutoramentos : p�s-doutoramentos
posi�ao : posi��o
poupanca : poupan�a
Praca : Pra�a
practicas : pr�cticas
practico : pr�ctico
Praticos : Pr�ticos
praticos : pr�ticos
pre-aviso : pr�-aviso
pre-definidas : pr�-definidas
pre-destinadas : pr�-destinadas
pre-determinada : pr�-determinada
pre-determinado : pr�-determinado
pre-difundidas : pr�-difundidas
pre-hist�ricos : pr�-hist�ricos
pre-inscri�ao : pr�-inscri��o
pre-produtos : pr�-produtos
pre-propostas : pr�-propostas
pre-requisitos : pr�-requisitos
pre-viagem : pr�-viagem
precaria : prec�ria
precedencias : preced�ncias
precisao : precis�o
precisariamos : precisar�amos
precisavamos : precis�vamos
preco : pre�o
precos : pre�os
preferivel : prefer�vel
preferivel : prefer�vel
prejuizo : preju�zo
prejuizos : preju�zos
PREMIOS : PR�MIOS
premios : pr�mios
preparatorio : preparat�rio
PRESENCA : PRESEN�A
Presidencia : Presid�ncia
presidencia : presid�ncia
pressao : press�o
pressupoe : pressup�e
pretendiamos : pretend�amos
preve : prev�
preve-se : prev�-se
preveem : prev�em
Previdencia : Previd�ncia
previo : pr�vio
previsao : previs�o
previsivel : previs�vel
previsoes : previs�es
principe : pr�ncipe
principios : princ�pios
prioritaria : priorit�ria
prioritarias : priorit�rias
prioritario : priorit�rio
prioritarios : priorit�rios
prisao : pris�o
problematica : problem�tica
problematico : problem�tico
profissao : profiss�o
programaveis : program�veis
propoe : prop�e
propoes : prop�es
propria : pr�pria
proprias : pr�prias
proprietarios : propriet�rios
proprio : pr�prio
proprios : pr�prios
protec�ao : protec��o
PROTOTIPO : PROT�TIPO
prototipo : prot�tipo
prototipos : prot�tipos
provavel : prov�vel
provisoria : provis�ria
proxima : pr�xima
PROXIMAS : PR�XIMAS
proximas : pr�ximas
proximo : pr�ximo
proximos : pr�ximos
pseudonimo : pseud�nimo
psicologicas : psicol�gicas
psicologico : psicol�gico
psicologicos : psicol�gicos
Psicotecnicos : Psicot�cnicos
publicitario : publicit�rio
publicos : p�blicos
pudessemos : pud�ssemos
punivel : pun�vel
queriamos : quer�amos
questao : quest�o
questionario : question�rio
questoes : quest�es
quimica : qu�mica
Quimicos : Qu�micos
raca : ra�a
raciocinio : racioc�nio
radio-telegrafista : r�dio-telegrafista
radiologicas : radiol�gicas
rapida : r�pida
rapidas : r�pidas
rapido : r�pido
rapidos : r�pidos
razao : raz�o
razoavel : razo�vel
realcou : real�ou
realizac�o : realiza��o
realizarao : realizar�o
recem : rec�m
recem-chegadas : rec�m-chegadas
recem-licenciados : rec�m-licenciados
recessao : recess�o
reclama�oes : reclama��es
recomendavel : recomend�vel
reconheciveis : reconhec�veis
reconversao : reconvers�o
recordarao : recordar�o
recursao : recurs�o
referendario : referend�rio
reflexao : reflex�o
REFORCADO : REFOR�ADO
reforcar : refor�ar
reforco : refor�o
Regiao : Regi�o
regiao : regi�o
regioes : regi�es
relatorio : relat�rio
relatorios : relat�rios
relevancia : relev�ncia
religiao : religi�o
relogio : rel�gio
renovaveis : renov�veis
rentavel : rent�vel
representac�o : representa��o
reproduc�o : reprodu��o
requisi�ao : requisi��o
requisitavel : requisit�vel
residencias : resid�ncias
resistencia : resist�ncia
resolu�oes : resolu��es
responderao : responder�o
responsaveis : respons�veis
responsavel : respons�vel
reune : re�ne
REUNIAO : REUNI�O
reuniao : reuni�o
reunioes : reuni�es
revisao : revis�o
revisoes : revis�es
ridiculo : rid�culo
Rigido : R�gido
Robotica : Rob�tica
rodoviario : rodovi�rio
ROMENIA : ROM�NIA
sabado : �bado
sabatica : ab�tica
saberao : aber�o
salao : al�o
salarios : al�rios
satelite : at�lite
satelites : at�lites
satisfatoria : atisfat�ria
satisfatorio : atisfat�rio
saudavel : aud�vel
Saude : Sa�de
saude : a�de
Sebastiao : Sebasti�o
Secretario-Geral : Secret�rio-Geral
secundario : ecund�rio
seguirao : eguir�o
seguranca : eguran�a
semantica : em�ntica
semanticos : em�nticos
semi-automatica : emi-autom�tica
seminario : emin�rio
SEMINARIOS : SEMIN�RIOS
seminarios : emin�rios
senao : en�o
Senior : S�nior
sensa�ao : ensa��o
sensivel : ens�vel
sequencia : equ�ncia
sequencias : equ�ncias
sera : er�
serao : er�o
Serios : S�rios
servico : ervi�o
servicos : ervi�os
servicos-piloto : ervi�os-piloto
SESSAO : SESS�O
sessao : ess�o
Sessoes : Sess�es
sessoes : ess�es
signatario : ignat�rio
silicio : il�cio
Simbolica : Simb�lica
simbolos : �mbolos
simultaneas : imult�neas
simultaneo : imult�neo
simultaneos : imult�neos
sincronas : �ncronas
Sintacticos : Sint�cticos
sintactica : int�ctica
sintacticas : int�cticas
sintese : �ntese
sistematico : istem�tico
sitio : itio
sitios : �tios
situa�ao : itua��o
situac�es : itua��es
so : �
sociologicos : ociol�gicos
socios : �cios
socios-fundadores : �cios-fundadores
solidos : �lidos
solu�ao : olu��o
solu�oes : olu��es
Sovietica : Sovi�tica
sub-areas : ub-�reas
subcontrata�ao : ubcontrata��o
subdominio : ubdom�nio
submissao : ubmiss�o
subsidios : ubs�dios
substitui�ao : ubstitui��o
substituirao : ubstituir�o
Suecia : Su�cia
sufragio : ufr�gio
Sugestao : Sugest�o
sugestao : ugest�o
sugestoes : ugest�es
surgirao : urgir�o
suspensao : uspens�o
talao : tal�o
talhao : talh�o
tambem : tamb�m
tarifario : tarif�rio
Tecnicas : T�cnicas
tecnicas : t�cnicas
Tecnico : T�cnico
tecnico : t�cnico
tecnicos : t�cnicos
TECNOLOGICA : TECNOL�GICA
tecnologica : tecnol�gica
tecnologicas : tecnol�gicas
tecnologico : tecnol�gico
tecnologicos : tecnol�gicos
tecnologos : tecn�logos
telecomunica�oes : telecomunica��es
telefonica : telef�nica
telefonica : telef�nica
telefonicas : telef�nicas
TELEFONICO : TELEF�NICO
Telefonico : Telef�nico
telefonicos : telef�nicos
Telefonicos : Telef�nicos
telematica : telem�tica
telematicas : telem�ticas
telematicos : telem�ticos
telemoveis : telem�veis
Televigilancia : Televigil�ncia
televisao : televis�o
tematica : tem�tica
tematicas : tem�ticas
Tematicas : Tem�ticas
temporaria : tempor�ria
temporario : tempor�rio
tendencia : tend�ncia
tendencias : tend�ncias
tenis : t�nis
tensao : tens�o
teorica : te�rica
teoricas : te�ricas
teoricos : te�ricos
tera : ter�
terao : ter�o
teriamos : ter�amos
termica : t�rmica
territorio : territ�rio
terriveis : terr�veis
terrivel : terr�vel
tinhamos : t�nhamos
tipicas : t�picas
tipico : t�pico
Titulos : T�tulos
titulos : t�tulos
topico : t�pico
topicos : t�picos
torrao : torr�o
tostao : tost�o
tostoes : tost�es
trafego : tr�fego
transatlantica : transatl�ntica
transferencia : transfer�ncia
transferencias : transfer�ncias
transitarao : transitar�o
transitoria : transit�ria
Transitorias : Transit�rias
transmissao : transmiss�o
transmissoes : transmiss�es
transportavel : transport�vel
tras : tr�s
tres : tr�s
Turistico : Tur�stico
ultimos : �ltimos
uniao : uni�o
unica : �nica
unico : �nico
universitaria : universit�ria
universitarias : universit�rias
universitario : universit�rio
universitarios : universit�rios
urgencia : urg�ncia
urgentissimo : urgent�ssimo
uteis : �teis
utensilios : utens�lios
util : �til
utilitario : utilit�rio
utiliza�ao : utiliza��o
valida�ao : valida��o
valvulas : v�lvulas
vao : v�o
Varia�oes : Varia��es
variaveis : vari�veis
variavel : vari�vel
varios : v�rios
Vazao : Vaz�o
ve : v�
veem : v�em
veemencia : veem�ncia
verao : ver�o
verificaveis : verific�veis
vernaculo : vern�culo
Versao : Vers�o
versao : vers�o
versoes : vers�es
vespera : v�spera
viavel : vi�vel
video-conferencia : video-confer�ncia
video-conferencias : video-confer�ncias
VIDEOCONFERENCIA : VIDEOCONFER�NCIA
videoconferencia : videoconfer�ncia
vigencia : vig�ncia
vigesima : vig�sima
vinculos : v�nculos
vinganca : vingan�a
viola�ao : viola��o
virao : vir�o
virus : v�rus
VISAO : VIS�O
visao : vis�o
visitarao : visitar�o
visivel : vis�vel
visoes : vis�es
vitalicios : vital�cios
vivencia : viv�ncia
vocabulo : voc�bulo
Voce : Voc�
voce : voc�
voces : voc�s
volatil : vol�til
voltarao : voltar�o
volumicas : vol�micas
voluntarios : volunt�rios
terco : ter�o
Terca-feira : Ter�a-feira
doenca : doen�a
enderecada : endere�ada
enderecadas : endere�adas
enderecar : endere�ar
enderecarem : endere�arem
engracada : engra�ada
heranca : heran�a
joia : j�ia
Justica : Justi�a
semelhanca : emelhan�a
SEGURANCA : SEGURAN�A
satisfaca : atisfa�a
recomecam : recome�am
Luso-britanicas : Luso-brit�nicas
microscopio : microsc�pio
ORCAMENTO : OR�AMENTO
pequeno-almoco : pequeno-almo�o
pos : p�s
orcamental : or�amental
preguica : pregui�a
presenca : presen�a
pos-graduados : p�s-graduados
ADESAO : ADES�O
auto-suspensao : auto-suspens�o
Ascensao : Ascens�o
conversao : convers�o
� : �
ab�boda : ab�bada
absti-me : abstive-me
abstrato : abstracto
ace�o : acesso
acelarar : acelerar
�cerca : acerca
acer��o : asser��o
acessabilidade : acessibilidade
aceza : acesa
acezo : aceso
acord�os : ac�rd�os
a�oreano : a�oriano
a�ossiar : associar
actris : actriz
adamastor : Adamastor
adeuzinho : adeusinho
Adotamos : Adoptamos
adotar : adoptar
adquir�-los : adquiri-los
a�rio : a�reo
aero-clube : aeroclube
ageitar : ajeitar
agonisar : agonizar
agradaveis : agrad�veis
ajuisar : ajuizar
album : �lbum
albuns : �lbuns
alerjia : alergia
alfasema : alfazema
alforje : alforge
algasarra : algazarra
alger�s : algeroz
algoses : algozes
alissiante : aliciante
alissiar : aliciar
alizar : alisar
alumeia : alumia
�manh� : amanh�
�mbigua : amb�gua
�mbiguidade : ambiguidade
amenisar : amenizar
analizador : analisador
analizar : analisar
an�lize : an�lise
�ncia : �nsia
ansestral : ancestral
ansestralidade : ancestralidade
ansiolitico : ansiol�tico
ansiul�tico : ansiol�tico
antig�idade : antiguidade
aporado : apurado
aporar : apurar
aporteguesamento : aportuguesamento
aporteguesar : aportuguesar
aquem : aqu�m
�quem : aqu�m
aqu� : aqui
arborisar : arborizar
arid�s : aridez
armazem : armaz�m
armazens : armaz�ns
arquiteto : arquitecto
Arquitetura : Arquitectura
arrange : arranje
arrangei : arranjei
arrangemos : arranjemos
arranges : arranjes
arrazado : arrasado
arrazar : arrasar
arrea : arreia
arregassado : arrega�ado
arregassar : arrega�ar
artf�cio : artif�cio
as�fama : az�fama
ascen��o : ascens�o
aseite : azeite
asenha : azenha
asia : azia
asimute : az�mute
ass�s : assaz
asse�o : acesso
assers�o : asser��o
assesso : acesso
Assessoria : Acessoria
assossiar : associar
ass�car : a��car
assucena : a�ucena
atabalhuar : atabalhoar
atarrachar : atarraxar
aterrorisar : aterrorizar
atl�ctico : atl�tico
atrai��e : atrai�oe
atraissoar : atrai�oar
atraiste : atra�ste
atraves : atrav�s
atravez : atrav�s
atraz : atr�s
atrazar : atrasar
atrazo : atraso
atribuia : atribu�a
atribuiam : atribu�am
atribuiamos : atribu�amos
atribuimos : atribu�mos
atribuiram : atribu�ram
atribu�rei : atribuirei
atribuirem : atribu�rem
atribu�remos : atribuiremos
atribuitivo : atributivo
atriz : actriz
atual : actual
audio-visual : audiovisual
Autoestradas : Auto-estradas
automatisa��o : automatiza��o
autorisar : autorizar
autosuspens�o : auto-suspens�o
autosuspenso : auto-suspenso
autosustenta��o : auto-sustenta��o
averigue : averig�e
avizado : avisado
avizar : avisar
avizo : aviso
az�ago : aziago
azuleijo : azulejo
azuleijos : azulejos
babozeira : baboseira
babuseira : baboseira
bacharlato : bacharelato
bactriana : bacteriana
badagaio : vadagaio
balisa : baliza
banderilha : bandarilha
baptisar : baptizar
baqueteriano : bacteriano
barcassa : barca�a
barr�co : barroco
barr�cos : barrocos
basar : bazar
bas�fia : baz�fia
batizar : baptizar
baze : base
b�be : beb�
b�b� : beb�
belesa : beleza
bemequer : bem-me-quer
Bemfica : Benfica
ben��o : b�n��o
benificia��es : beneficia��es
benificiar : beneficiar
benquerer : bem-querer
benvindo : bem-vindo
berbulha : borbulha
bisarro : bizarro
bisexto : bissexto
bisexual : bissexual
bisexualidade : bissexualidade
bissectris : bissectriz
bissessual : bissexual
bissetriz : bissectriz
bocage : Bocage
boia : b�ia
boiam : b�iam
boie : b�ie
boiem : b�iem
boio : b�io
bolir : bulir
bonus : b�nus
borbolha : borbulha
borbolhar : borbulhar
braza : brasa
brazil : Brasil
bregeiro : brejeiro
briza : brisa
bruxelas : Bruxelas
bujiar : bugiar
burborinho : burburinho
busina : buzina
cafeina : cafe�na
cafeseiro : cafezeiro
caichilho : caixilho
caiem : caem
caimbras : c�ibras
ca�mbras : c�ibras
ca�ndo : caindo
ca�r : cair
ca�r-lhe : cair-lhe
caira : ca�ra
ca�r� : cair�
cairam : ca�ram
ca�r�o : cair�o
ca�r�s : cair�s
ca�rdes : cairdes
cairem : ca�rem
ca�remos : cairemos
caires : ca�res
cairmos : ca�rmos
ca�rmos : cairmos
calc�reo : calc�rio
c�lis : c�lice
calsar : cal�ar
calvice : calv�cie
campa�nha : campainha
campi�o : campe�o
can�ar : cansar
can�aso : cansa�o
can�asso : cansa�o
cans�o : can��o
c�osinho : c�ozinho
c�oz�nho : c�ozinho
cap�s : capaz
captivo : cativo
car�cteres : caracteres
carangueijo : caranguejo
carateres : caracteres
carcassa : carca�a
cardio-vascular : cardiovascular
Carissimos : Car�ssimos
carlos : Carlos
carmos : Carmos
carrocel : carrossel
carroucel : carrossel
cartom�ncia : cartomancia
casc�vel : cascavel
cassarola : ca�arola
catalizar : catalisar
cat�lize : cat�lise
catura : captura
causad�aco : caus�dico
c�ra : cera
c�rca : cerca
c�rca : cerca
cerim�nia : cerim�nia
cerralheiro : erralheiro
cert�me : certame
certesa : certeza
cet�sseo : cet�ceo
ceu : c�u
cezariana : cesariana
chaile : xaile
chale : xale
chapeu : chap�u
chasso : cha�o
chatiar : chatear
chatiava : chateava
chatisse : chatice
chech� : xex�
ch�ch� : xex�
cheinho : cheiinho
che�nho : cheiinho
che�ssimo : chei�ssimo
ch�cara : x�cara
chuxa : chucha
cicatrisar : cicatrizar
cicratisar : cicatrizar
cintaxe : intaxe
ciume : ci�me
claresa : clareza
classismo : classicismo
cobissa : cobi�a
coca-cola : Coca-cola
c�dia : c�dea
colectivisa��o : colectiviza��o
coletiviza��o : colectiviza��o
colijir : coligir
colin�ria : culin�ria
colizeu : coliseu
comb�io : comboio
comperativa : cooperativa
complementariedade : complementaridade
compreen��o : compreens�o
comprendeu : compreendeu
compurscar : conspurcar
comumente : comummente
concenso : consenso
concluia : conclu�a
concluira : conclu�ra
conclu�rmos : concluirmos
conclu�u : concluiu
condizessem : condissessem
cond�-la : condu-la
condus : conduz
condusir : conduzir
conecs�o : conex�o
conexionados : conexos
c�ngegue : c�njuge
c�njuga : c�njuge
c�njugue : c�njuge
conscencioso : consciencioso
consciencia : consci�ncia
consegui-se : conseguisse
conserne : concerne
consernir : concernir
consider : considere
consinteis : consintais
consomas : consumas
consomir : consumir
consporcar : conspurcar
Constacto : Constato
constitue : constitui
constituia : constitu�a
constitu�ndo : constituindo
constituira : constitu�ra
constituitivo : constitutivo
constroiem : constroem
construi : constru�
construia : constru�a
cont�em : cont�m
contens : cont�ns
conti-me : contive-me
contra-prova : contraprova
contracto : contrato
contractos : contratos
contrai-lo : contra�-lo
contraiem : contraem
contrassenso : contra-senso
contribu�nte : contribuinte
contribuitivo : contributivo
contric��o : contri��o
control : controlo
contr�le : controlo
convem : conv�m
convens : conv�ns
convir : convier
c�r : cor
c�r : cor
corajem : coragem
cordeal : cordial
c�res : cores
c�res : cores
coroneis : coron�is
corr�colo : curr�culo
corr�culo : curr�culo
corropio : corrupio
cortezia : cortesia
coscovilheiras : coscuvilheiras
coscovilhice : coscuvilhice
cr�neo : cr�nio
crea��o : cria��o
creador : criador
crear : criar
creatura : criatura
creem : cr�em
cr�m : cr�em
creoulo : crioulo
cristamente : crist�mente
cristanmente : crist�mente
crusador : cruzador
crusar : cruzar
cruseiro : cruzeiro
cubi�a : cobi�a
cubi�ar : cobi�ar
culidir : colidir
culigir : coligir
culina : colina
culis�o : colis�o
culiseu : coliseu
curr�colo : curr�culo
curropio : corrupio
custume : costume
da-me : d�-me
damos-nos : damo-nos
dansar : dan�ar
darnos : dar-nos
decaiem : decaem
defenido : definido
defeza : defesa
degec��o : dejec��o
degejuar : desjejuar
degejum : desjejum
degladiar : digladiar
deix�sse-mos : deix�ssemos
deje��o : dejec��o
dejetos : dejectos
deleciosas : deliciosas
delegenciar : diligenciar
deligencia : dilig�ncia
d�m : d�em
deminuto : diminuto
d�mos : demos
dep�r : depor
depos : dep�s
depoz : dep�s
depremido : deprimido
depremir : deprimir
derruido : derru�do
desa�ocego : desassossego
desac�rdo : desacordo
desassocego : desassossego
desassossiar : desassociar
descan�ar : descansar
descan�o : descanso
descelar : desselar
descontra��o : descontrac��o
descubri : descobri
desenchabido : desenxabido
desenteria : disenteria
desfasajem : desfasagem
desfazagem : desfasagem
desfazer-te-ia : desfar-te-ia
desfeicho : desfecho
desf�s : desfez
deshabitar : desabitar
desharmonia : desarmonia
deshonestidade : desonestidade
deshonesto : desonesto
deshonra : desonra
desiquel�brio : desequil�brio
desiquil�brio : desequil�brio
deslisar : deslizar
deslise : deslize
desmoralisar : desmoralizar
desoito : dezoito
despachanta : despachante
desped�-la : despedi-la
desp�ndio : disp�ndio
despendioso : dispendioso
despeza : despesa
despr�zo : desprezo
despr�zo : desprezo
desseminado : disseminado
desseminar : disseminar
desser : descer
dessimula��o : dissimula��o
dessimulado : dissimulado
dessimular : dissimular
destinta : distinta
destroi : destr�i
destruido : destru�do
deteu : deteve
dexer : descer
dezacordo : desacordo
deza�ossiar : desassociar
dezalinho : desalinho
dezentendimento : desentendimento
dezespero : desespero
dez�ito : dezoito
d�-lo : di-lo
di��o : dic��o
diccion�rio : dicion�rio
dignat�rio : dignit�rio
dignit�reo : dignit�rio
dijerir : digerir
dijest�o : digest�o
dijiro : digiro
diminuiram : diminu�ram
diminuitivo : diminutivo
dinossaurios : dinoss�urios
di�nisicas : dionis�acas
dirijisse : dirigisse
dis : diz
discre��o : discri��o
discu��es : discuss�es
diser : dizer
disfruta-se : desfruta-se
disfrutado : desfrutado
disfrutador : desfrutador
disfrutar : desfrutar
disfrute : desfrute
dispar : d�spar
dispendedor : despendedor
dispender : despender
dispendido : despendido
disposer : dispuser
dissere : disser
dissereis : diss�reis
dissuador : dissuasor
dissuazivo : dissuasivo
dissuazor : dissuasor
disten��o : distens�o
distrai-lo : distra�-lo
distraiem : distraem
distra�r : distrair
distribui-lo : distribu�-lo
districto : distrito
div�rgencia : diverg�ncia
dizer-se-� : dir-se-�
dizer-se-�o : dir-se-�o
dizer-te-ia : dir-te-ia
d�o : doo
eboliente : ebuliente
efabola��o : efabula��o
efabolar : efabular
�febo : efebo
efeveresc�ncia : efervesc�ncia
efeversc�ncia : efervesc�ncia
egoismo : ego�smo
egurgitar : ingurgitar
egurjitar : ingurgitar
eide : hei-de
electro-encefalograma : electroencefalograma
elejer : eleger
eletrotecnica : electrot�cnica
�lite : elite
el�tico : el�ptico
elocidar : elucidar
embaixadora : embaixatriz
embevedar : embebedar
embevedava : embebedava
embriagu�s : embriaguez
embucadura : embocadura
embulado : embolado
embular : embolar
embuscada : emboscada
emi��o : emiss�o
emi�ora : emissora
emita��o : imita��o
emitar : imitar
emmagrecer : emagrecer
emmoldurar : emoldurar
empreza : empresa
encaiches : encaixos
encaxes : encaixes
encertar : encetar
enchada : enxada
enchado : inchado
enchar : inchar
enchovalhada : enxovalhada
enchovalhar : enxovalhar
enchugar : enxugar
enchuto : enxuto
enc�modo : inc�modo
encomudo : inc�modo
encorage : encoraje
enesqueciveis : inesquec�veis
enesquecivel : inesquec�vel
�nfa-se : �nfase
engorjitar : engorgitar
engrachador : engraxador
engrachar : engraxar
engurgitar : engorgitar
enluada : aluada
enovador : inovador
ent�o : entoo
entr�va-mos : entr�vamos
entreteste-te : entretiveste-te
entreteu-se : entreteve-se
entreti-me : entretive-me
entretiam : entretinham
entumescer : intumescer
entumescia : intumescia
entupes : entopes
enviezado : enviesado
enxagoar : enxaguar
equisema : eczema
erban�rio : ervan�rio
erban�rio : herban�rio
ereis : �reis
eremita : ermita
erimita : ermita
eritrocitos : eritr�citos
erodito : erudito
erpes : herpes
�rro : erro
�rro : erro
er�dito : erudito
esb��o : esbo�o
esb��o : esbo�o
esclamar : exclamar
esclamou : exclamou
esclusivo : exclusivo
esdr�xola : esdr�xula
esfero-gr�fica : esferogr�fica
esforsam : esfor�am
esgaseado : esgazeado
es�mio : ex�mio
esmaltear : esmaltar
espaguete : esparguete
especime : esp�cime
especimens : esp�cimes
espectativas : expectativas
espertesa : esperteza
esp�sso : espesso
espetativa : expectativa
espicassar : espica�ar
espontaniedade : espontaneidade
espont�nio : espont�neo
espont�nio : espont�neo
esp�sa : esposa
esp�so : esposo
espurgar : expurgar
esquesitisse : esquisitice
esquesito : esquisito
establecer : estabelecer
estenuante : extenuante
estepor : estupor
esteporado : estuporado
estipid�s : estupidez
est�mago : est�mago
estors�o : extors�o
est�rvo : estorvo
est�rvo : estorvo
estranhesa : estranheza
estranjeirismo : estrangeirismo
estranjeiro : estrangeiro
estratejista : estrategista
estravag�ncias : extravag�ncias
estravasar : extravasar
estraviar : extraviar
estreitesa : estreiteza
estrelato : estrelado
estr�pido : estr�pito
estrovar : estorvar
estructurado : estruturado
estupurado : estuporado
esvasiar : esvaziar
et�rio : et�reo
eutan�zia : eutan�sia
evitae : evitai
exceps�o : excep��o
exceto : excepto
exdr�xula : esdr�xula
exdr�xulas : esdr�xulas
eximio : ex�mio
exitar : hesitar
exito : hesito
expecialmente : especialmente
expesso : espesso
expl�ndido : espl�ndido
explendor : esplendor
expont�neo : espont�neo
Extender : Estender
extendidos : estendidas
extor��o : extors�o
extravazar : extravasar
fabolar : fabular
faboloso : fabuloso
fac-simile : fac-s�mile
fachina : faxina
faisca : fa�sca
fa�scar : faiscar
falariam-nos : falar-nos-iam
fal�steis : falastes
far�a : farsa
far�a-mos : far�amos
farramenta : ferramenta
faser : fazer
faz�-lo-ias : f�-lo-ias
fazer-se-� : far-se-�
fazer-se-�o : far-se-�o
femenilidade : feminilidade
f�mur : f�mur
femural : femoral
ferr�gem : ferrugem
ferrujem : ferrugem
fertilisar : fertilizar
f�-lo : fi-lo
fiabelidade : fiabilidade
fiablidade : fiabilidade
finaflor : fina-flor
fiqueim : fiquem
fiscalisa��o : fiscaliza��o
fiscalisar : fiscalizar
f�sicos-qu�micos : f�sico-qu�micos
fisilogia : fisiologia
fiz-lo : fi-lo
fizes-te : fizeste
flu�dez : fluidez
fl�idez : fluidez
fluidico : flu�dico
flu�do : fluido
fogu�te : foguete
f�r : for
f�ra : fora
f�r�a : for�a
f�rem : forem
formusura : formosura
f�ro : foro
fortivo : furtivo
forum : f�rum
foruns : f�runs
fosforecente : fosforescente
fransido : franzido
fransir : franzir
fraquesa : fraqueza
frenezi : frenesi
frenezim : frenesim
freza : fresa
frezadora : fresadora
friza : frisa
frizar : frisar
frizo : friso
frustat�rio : frustrat�rio
fugire : fugir
furmosura : formosura
furmusura : formosura
furtuito : fortuito
furtunas : fortunas
gabardine : gabardina
galin�cio : galin�ceo
gasela : gazela
gasua : gazua
gazeado : gaseado
geito : jeito
geitosa : jeitosa
g�rme : germe
germen : g�rmen
gerundio : ger�ndio
giboia : jib�ia
gib�ia : jib�ia
gib�ia : jib�ia
gimn�sio : gin�sio
giradiscos : gira-discos
gis : giz
gordoroso : gorduroso
gorgeta : gorjeta
goso : gozo
g�zo : gozo
gracil : gr�cil
gra�nha : grainha
grangear : granjear
gratu�to : gratuito
gravid�s : gravidez
gravideses : gravidezes
GRECIA : GR�CIA
gromete : grumete
grum�te : grumete
gurdoroso : gorduroso
habitoo-se : habituou-se
hainda : ainda
helimotor : heliomotor
helioporto : heliporto
hemorregia : hemorragia
heriditariedade : hereditariedade
hervan�rio : ervan�rio
hervan�rio : herban�rio
heterog�neo : heterog�neo
heterog�nias : heterog�neas
heterog�nio : heterog�neo
hexitar : hesitar
h�xito : �xito
hidrog�neo : hidrog�nio
hidrog�nio : hidrog�nio
hieroglifos : hier�glifos
higi�ne : higiene
hijiene : higiene
hilariedade : hilaridade
hiper-sensibilidade : hipersensibilidade
hipnotisa��o : hipnotiza��o
hipnotisado : hipnotizado
hipnotisador : hipnotizador
hipnotisar : hipnotizar
hipnoze : hipnose
hipodromo : hip�dromo
hiredit�rio : heredit�rio
holand�ses : holandeses
homo-sexualidade : homossexualidade
homog�neo : homog�neo
homog�nio : homog�neo
homogenizar : homogeneizar
horisonte : horizonte
h�stil : hostil
hovesse : houvesse
�am : iam
iamos : �amos
�as : ias
�bero : ibero
idealogia : ideologia
idenpotente : idempotente
identica : id�ntica
idoniedade : idoneidade
ieis : �eis
igiene : higiene
ilhoses : ilh�s
ilucidar : elucidar
imcompleto : incompleto
imiss�o : emiss�o
imperadora : imperatriz
impertigado : empertigado
imploz�o : implos�o
implus�o : implos�o
impolsionar : impulsionar
imp�dico : impudico
impulsiunar : impulsionar
imundice : imund�cie
inabeis : in�beis
in�udito : inaudito
incer��o : inser��o
incerir : inserir
incluia : inclu�a
incluiam : inclu�am
incluido : inclu�do
inclu�ndo : incluindo
incluiram : inclu�ram
inclu�r�o : incluir�o
inclu�rdes : incluirdes
incluir�a : incluiria
inclu�ria : incluiria
inclu�rmos : incluirmos
incluisse : inclu�sse
inclu�u : incluiu
inclusiv� : inclusive
inconpleto : incompleto
incorajar : encorajar
incrostar : incrustar
incrostrada : incrustada
indiv�dua : indiv�duo
infraestrutura : infra-estrutura
Infraestrutura : Infra-estrutura
infraestruturas : infra-estruturas
ingec��es : injec��es
ingl�ses : ingleses
inglezice : inglesice
inglezisse : inglesice
inh�bil : in�bil
�nicio : in�cio
inje��o : injec��o
insers�o : inser��o
insistencia : insist�ncia
inssondaveis : insond�veis
inssurrei��o : insurrei��o
insurreiss�o : insurrei��o
inter-comunicador : intercomunicador
inter-institucionais : interinstitucionais
inter-sexual : intersexual
inter-sexualidade : intersexualidade
inter�sses : interesses
intergei��o : interjei��o
interrop��o : interrup��o
intersecsual : intersexual
intervia : intervinha
intervido : intervindo
intervisse : interviesse
interviu : interveio
intransij�ncia : intransig�ncia
intransijente : intransigente
intranzijente : intransigente
intrepor : interpor
intrevido : intervindo
intrevisto : entrevisto
intuia : intu�a
inxugar : enxugar
inxuto : enxuto
ir-mos : irmos
irrasc�vel : irasc�vel
items : itens
itener�rio : itiner�rio
jiboia : jib�ia
joia : j�ia
j�vem : jovem
j�vens : jovens
joventude : juventude
ju�so : ju�zo
juizes : ju�zes
juizo : ju�zo
junho : Junho
j�niores : juniores
juri : j�ri
Kg : kg
kilo : quilo
kil�metro : quil�metro
Km : km
ladiar : ladear
lage : laje
lagem : lajem
lambusado : lambuzado
lampe�o : lampi�o
lapis : l�pis
largato : lagarto
Latinoamericano : Latino-americano
l�-la : l�-la
les�ria : lez�ria
letivo : lectivo
leucocitos : leuc�citos
levesa : leveza
li�en�as : licen�as
licensas : licen�as
licensiado : licenciado
liche : lixe
ligeiresa : ligeireza
lijeireza : ligeireza
lijeiro : ligeiro
limpesa : limpeza
lingu�sta : linguista
linguistica : lingu�stica
linxado : linchado
l�gicamente : logicamente
logotipo : log�tipo
logutipo : log�tipo
l�mbago : lumbago
lunbago : lumbago
l�polo : l�pulo
lusitaneidade : lusitanidade
lusitaniedade : lusitanidade
ma�agista : massagista
macissos : maci�os
madre-silva : madressilva
magestoso : majestoso
magresa : magreza
m�gua : m�goa
mal-casado : malcasado
mal-cheiroso : malcheiroso
mal-contente : malcontente
mal-criado : malcriado
mal-feito : malfeito
mal-me-quer : malmequer
mal-nascido : malnascido
mal-visto : malvisto
malavisado : mal-avisado
malencarado : mal-encarado
malentendidos : mal-entendidos
malidic�ncias : maledic�ncias
mamarraxo : mamarracho
mangan�s : mangan�s
mangerico : manjerico
mantem-se : mant�m-se
manti-me : mantive-me
Mariza : Marisa
marm�rico : marm�reo
marm�rio : marm�reo
martirisar : martirizar
matris : matriz
mausoleu : mausol�u
mecher : mexer
mecher-lhe : mexer-lhe
m�dica-cir�rgica : m�dico-cir�rgica
m�dicos-cir�rgicos : m�dico-cir�rgicos
mediocre : med�ocre
medium : m�dium
mediuns : m�diuns
memorandu : memorando
menistro : ministro
mens�o : men��o
mensionar : mencionar
mercieiro : merceeiro
meret�ssimo : merit�ssimo
meseric�rdia : miseric�rdia
m�ta : meta
m�ta : meta
meteriologia : meteorologia
m�tro : metro
microinform�tica : micro-inform�tica
min�mo : m�nimo
minissaia : mini-saia
miradoro : miradouro
miuda : mi�da
miudo : mi�do
mixto : misto
moiem : moem
mo�nho : moinho
m�lhos : molhos
monoc�rdia : monoc�rdica
monotunia : monotonia
m�o : moo
mormura : murmura
mormurar : murmurar
mostr�o : mostram
mostreios : mostrei-os
mu� : mo�
mulhado : molhado
multim-media : multim�dia
municioso : minucioso
munotonia : monotonia
muribundo : moribundo
mussulmano : mu�ulmano
mustrar : mostrar
neo-latino : neolatino
neuro-ps�quico : neurops�quico
nitrog�neo : nitrog�nio
nitrog�nio : nitrog�nio
nobresa : nobreza
norueste : noroeste
notabiliza��o : notabilidade
n�vel : novel
nuno : Nuno
n�vem : nuvem
obce��o : obsess�o
obcess�o : obsess�o
obcessivo : obsessivo
obececar : obcecar
obetenho : obtenho
obezidade : obesidade
obj�ctivo : objectivo
Objetos : Objectos
obrigatoriadade : obrigatoriedade
obseca��o : obceca��o
obsecado : obcecado
obse��o : obsess�o
obsecar : obcecar
obsecass�o : obceca��o
obseletos : obsoletos
obsequia : obsequeia
obsuletos : obsoletos
obzequiar : obsequiar
�ca : oca
�co : oco
ocurrer : ocorrer
odia : odeia
odie : odeie
odiem : odeiem
ogemose : osmose
olfativo : olfactivo
oliar : olear
�lio : �leo
omi�o : omisso
onanimista : unanimista
openi�o : opini�o
�pinar : opinar
op�r : opor
organisa��o : organiza��o
organisar : organizar
org�os : �rg�os
or�gem : origem
ostrassismo : ostracismo
�timo : �ptimo
ourina : urina
ourinar : urinar
ourinol : urinol
outubro : Outubro
ouv�-lo : ouvi-lo
oxila��es : oscila��es
r� : p'pr�
paci�nsia : paci�ncia
pagem : pajem
paizagem : paisagem
pandega : p�ndega
p�ndigo : p�ndego
paposseco : papo-seco
para-choques : p�ra-choques
parachoques : p�ra-choques
paraliza��o : paralisa��o
paralizar : paralisar
paraquedas : p�ra-quedas
pararraios : p�ra-raios
parteleira : prateleira
parvoice : parvo�ce
passeo : passeio
passiar : passear
passiei : passeei
passiemos : passeemos
passi�ncia : paci�ncia
p�teo : p�tio
patrim�nio : patrim�nio
pchisbeque : pechisbeque
p�cego : p�ssego
p�che : peixe
peco�ria : pecu�ria
ped�-la-ei : pedi-la-ei
p�ga : pega
p�ga : pega
p�gada : pegada
peiche : peixe
penalisante : penalizante
pendoricalho : penduricalho
penduresa : pendureza
penecilina : penicilina
penincilina : penicilina
pequen�s : pequenez
pera : p�ra
p�ras : peras
perceisamente : precisamente
perceito : preceito
perceptorado : preceptorado
perclaro : preclaro
perconizar : preconizar
percu�ria : pecu�ria
p�rda : perda
perdominar : predominar
perduar : perdoar
perduou : perdoou
perferivel : prefer�vel
periodo : per�odo
perju�zo : preju�zo
permissa : premissa
perp�cio : prep�cio
persagiam : pressagiam
persentido : pressentido
perspetiva : perspectiva
persta��es : presta��es
persuaz�o : persuas�o
pertens�o : pretens�o
perver��o : pervers�o
pesarozo : pesaroso
pesc��o : pesco�o
p�so : peso
pesso : pe�o
petisa : petiza
petr�lio : petr�leo
p�xe : peixe
pezadelo : pesadelo
pezar : pesar
pezaroso : pesaroso
pictoresco : pinturesco
pil�to : piloto
pil�tos : pilotos
pintoresco : pinturesco
pique-nique : piquenique
piquena : pequena
pirezinho : piresinho
piroupo : piropo
pituresco : pitoresco
piugada : peugada
plat�ia : plateia
pleiade : pl�iade
po-lo : p�-lo
pobresa : pobreza
pobresinho : pobrezinho
poco : pouco
p�co : pouco
podera : pudera
poderam : puderam
poderia-me : poder-me-ia
podessemos : pud�ssemos
poem : p�em
p�em : p�em
polas : pulas
polig�mia : poligamia
politecnico : polit�cnico
ponteagudo : pontiagudo
porlongar : prolongar
porlongue : prolongue
portec��o : protec��o
portugues : portugu�s
portugu�sa : portuguesa
portugu�smente : portuguesmente
porvid�ncia : provid�ncia
pos : p�s
poseres : puseres
posescolar : p�s-escolar
posesses : pusesses
posglaci�rio : p�s-glaci�rio
posoperat�rio : p�s-operat�rio
possiblidade : possibilidade
possiveis : poss�veis
possivel : poss�vel
potuguezismo : portuguesismo
p�z-se : p�s-se
pozes : poses
poz�sseis : pus�sseis
poz�ssemos : pus�ssemos
pozinhos : posinhos
pr� : pr�
precal�o : percal�o
preceitoar : preceituar
preceveran�a : perseveran�a
precizar : precisar
preconisar : preconizar
predidos : perdidos
predum�nio : predom�nio
prefazer : perfazer
preju�so : preju�zo
prejuizo : preju�zo
premear : premiar
pr�meo : pr�mio
premiss�o : permiss�o
prenc�pio : princ�pio
prenh�s : prenhez
preplexidade : perplexidade
preplexo : perplexo
prescruta��o : perscruta��o
prescrutador : perscrutador
prespectiva : perspectiva
pressajiar : pressagiar
presserverar : perseverar
presseveran�a : perseveran�a
prestass�es : presta��es
presuas�o : persuas�o
preten��o : pretens�o
pretencioso : pretensioso
pretesto : pretexto
prevers�o : pervers�o
preversidade : perversidade
preverso : perverso
preverter : perverter
previl�gio : privil�gio
prezumido : presumido
prezun��o : presun��o
primasia : primazia
pr�ncepe : pr�ncipe
principe : pr�ncipe
priveligiado : privilegiado
probolemas : problemas
procheneta : proxeneta
productos : produtos
profundesa : profundeza
progre��o : progress�o
projeto : projecto
projetos : projectos
promenor : pormenor
promenores : pormenores
propraga��o : propaga��o
propridade : propriedade
proroga��o : prorroga��o
prorogado : prorrogado
prorogar : prorrogar
prorrugar : prorrogar
prossessador : processador
protextar : protestar
protexto : protesto
prototipo : prot�tipo
provalvelmente : provavelmente
proventura : porventura
prov�ssemos : prov�ssemos
providenci�-lo : providenci�-lo
PROVINIENTE : PROVENIENTE
provinientes : provenientes
pruibido : proibido
psico-social : psicossocial
psico-som�tico : psicossom�tico
p�-la : pu-la
p�-lo : pu-lo
puder� : poder�
pulido : polido
pulimos : polimos
pulmunar : pulmonar
puresa : pureza
puz : pus
puzemos : pusemos
puzera : pusera
puzeram : puseram
puzeras : puseras
puzeres : puseres
puzermos : pusermos
puzesse : pusesse
puzesses : pusesses
puzeste : puseste
pxisbeque : pechisbeque
quartas-feiras : Quartas-feiras
queiremos : queiramos
quer-o : quere-o
quere : quer
quere-me : quer-me
quere-se : quer-se
quer�mo-lo : queremo-lo
qu�-lo : qui-lo
qui�a : qui��
qu�s : quis
quis-lo : qui-lo
quisere : quiser
quis�steis : quisestes
quiss� : qui��
quiz : quis
quizemos : quisemos
quizer : quiser
quizera : quisera
quizeram : quiseram
quiz�ramos : quis�ramos
quizeras : quiseras
quizerdes : quiserdes
quizerem : quiserem
quizeres : quiseres
quizesse : quisesse
quizessem : quisessem
quizeste : quiseste
quiz�steis : quisestes
rabuge : rabuje
rabujento : rabugento
rabujice : rabugice
rabuscada : rebuscada
r�dio-amador : radioamador
ra�nha : rainha
ra�z : raiz
rangir : ranger
rapasinho : rapazinho
r�pidamente : rapidamente
rasia : razia
raza : rasa
razo : raso
reajir : reagir
recaiem : recaem
recentimento : ressentimento
recentir : ressentir
recepiente : recipiente
rectroactivas : retroactivas
rectroactivo : retroactivo
rectroactivos : retroactivos
redatorial : redactorial
redijir : redigir
redol : Redol
reeinstalar : reinstalar
refelex�o : reflex�o
refer-se : refere-se
referirnos-emos : referir-nos-emos
refletir : reflectir
regei��o : rejei��o
regeitar : rejeitar
r�go : rego
regorgitar : regurgitar
reincarnar : reencarnar
reinvidica��es : reivindica��es
reinvidicar : reivindicar
rejeiss�o : rejei��o
rejisto : registo
rejovenescer : rejuvenescer
rejovenescimento : rejuvenescimento
relac��o : rela��o
relaccionados : relacionados
remedia : remedeia
remedio : remedeio
repucho : repuxo
repurt�rio : repert�rio
requere : requer
requere-se : requer-se
requesitos : requisitos
resgistados : registados
resplandesc�ncia : resplandec�ncia
resplandescente : resplandecente
ressaiem : ressaem
ressurjir : ressurgir
ressurreiss�o : ressurrei��o
r�stea : r�stia
restricto : restrito
restrinjir : restringir
reteu : reteve
reto : recto
reunes : re�nes
re�nir : reunir
reuno : re�no
rezina : resina
riagir : reagir
rid�colo : rid�culo
ringi : rangi
ringido : rangido
riquesa : riqueza
rob�ula : rub�ola
rolissa : roli�a
rolisso : roli�o
roptura : ruptura
rouxinois : rouxin�is
roxinol : rouxinol
r�brica : rubrica
ru� : ro�
ruido : ru�do
ruimente : ruimmente
sacrilegadamente : acrilegamente
saida : a�da
saiem : aem
saimos : a�mos
sa�ndo : aindo
sa�r : air
saira : a�ra
sa�r� : air�
sairam : a�ram
sa�r�o : air�o
sa�r�s : air�s
sa�rdes : airdes
sairem : a�rem
sa�remos : airemos
saires : a�res
sa�rmos : airmos
sa�u : aiu
salganhada : algalhada
saliba : aliva
salvaguadar : alvaguardar
saracotiar : aracotear
s�udade : audade
saude : a�de
sear : cear
secrestar : equestrar
secresto : equestro
secretar�a : ecretaria
segnificado : ignificado
seia : ceia
Sele��o : Selec��o
selecionar : eleccionar
selinidade : enilidade
selvajamente : elvaticamente
selvajem : elvagem
selvajeria : elvageria
semi-anual : emianual
semi-cerrado : emicerrado
semi-circular : emicircular
semi-eixo : emieixo
semi-oficioso : emioficioso
semi-vogal : emivogal
semihomem : emi-homem
semiinconsciente : emi-inconsciente
semirrei : emi-rei
semiss�bio : emi-s�bio
semisselvagem : emi-selvagem
sen�ura : censura
sensura : censura
sensuras : censuras
sera : cera
s�ra : cera
seram : er�o
sereal : cereal
ser�am : eriam
serimonioso : cerimonioso
serzir : cerzir
setim : cetim
setor : ector
setores : ectores
Sexta-Feira : Sexta-feira
sextas-feiras : Sextas-feiras
sifl�tico : ifil�tico
simbolo : �mbolo
sinosite : inusite
sintasse : intaxe
sint�tico : int�ctico
sintonisar : intonizar
sinuzite : inusite
s�be : oube
sobrecelente : obresselente
sobrehumano : obre-humano
sobridade : obriedade
socegado : ossegado
socegar : ossegar
socego : ossego
sociadade : ociedade
so�ubrar : o�obrar
socumbir : ucumbir
sodeste : udeste
sodueste : udoeste
s�mente : omente
son�mbolo : on�mbulo
sorjo : urjo
sorrizinho : orrisinho
sorv�te : orvete
sosinho : ozinho
sossobrar : o�obrar
sot�os : �t�os
sovieticos : ovi�ticos
s�zinho : ozinho
sub-delegado : ubdelegado
sub-grupo : ubgrupo
Sub-grupo : Subgrupo
sub-solos : ubsolos
subesservi�ncia : ubservi�ncia
subibliotec�rio : ub-bibliotec�rio
subito : �bito
subrepticiamente : ub-repticiamente
subrepticio : ub-rept�cio
substituia : ubstitu�a
substituitivo : ubstitutivo
substitu�u : ubstituiu
substracto : ubstrato
su�obrar : o�obrar
sujerir : ugerir
sujest�o : ugest�o
sunambulismo : onambulismo
s�per-homem : uper-homem
superhomem : uper-homem
suprassumo : upra-sumo
supre��o : upress�o
supresti��o : upersti��o
supresticioso : upersticioso
surjir : urgir
surpr�sa : urpresa
surpreza : urpresa
surrapa : zurrapa
survete : orvete
suspen��o : uspens�o
susseder : uceder
taboleiro : tabuleiro
talv�s : talvez
tambem : tamb�m
tartante : tratante
t�tica : t�ctica
t�tico : t�ctico
teem : t�m
tele-guiado : teleguiado
televizivo : televisivo
t�m : tem
tem-o : tem-no
t�nue : t�nue
t�nues : t�nues
terebentina : terebintina
terjeitos : trejeitos
terramoto : terremoto
terraplanagem : terraplenagem
terraplanar : terraplenar
terraqueo : terr�queo
terr�quio : terr�queo
t�steis : t�xteis
tetos : tectos
teurap�utico : terap�utico
texteis : t�xteis
t�xteis : t�xteis
tijela : tigela
tor�xico : tor�cico
torc�colo : torcicolo
tors�o : tor��o
torser : torcer
torsida : torcida
torsido : torcido
t�rso : torso
tot�m : totem
totens : t�temes
toxico : t�xico
tragect�ria : traject�ria
traiem : traem
traj�dia : trag�dia
trajeto : trajecto
trajet�ria : traject�ria
tr�jico : tr�gico
tranquilisador : tranquilizador
tranquilisante : tranquilizante
tr�nsido : transido
transmetir : transmitir
transmi��o : transmiss�o
transmitente : transmissor
tranze : transe
tranzido : transido
traser : trazer
traz�-lo-ei : tr�-lo-ei
traz�-lo-ia : tr�-lo-ia
trazeira : traseira
trazeiro : traseiro
trazer-nos-ia : trar-nos-ia
trazer-se-� : trar-se-�
trazer-se-�o : trar-se-�o
tregeitos : trejeitos
tres : tr�s
trez : tr�s
tri-campe�o : tricampe�o
tricampi� : tricampe�
trilingue : tril�ngue
tristesa : tristeza
tr�co : troco
trousse : trouxe
troussestes : trouxestes
tunel : t�nel
turc�colo : torcicolo
ultra-violeta : ultravioleta
�mido : h�mido
un�ssuno : un�ssono
urano : ur�nio
utilisar : utilizar
utlizadores : utilizadores
v�cum : vacum
vag�os : vag�es
vasio : vazio
v� : v�
veiculo : ve�culo
veinculado : veiculado
v�m : vem
v�rbo : verbo
v�rbo : verbo
veredito : veredicto
veria��o : verea��o
veriador : vereador
vert�gem : vertigem
vert�gens : vertigens
veses : vezes
veu : v�u
vi�steis : viestes
vintem : vint�m
v�rgem : virgem
visinhan�a : vizinhan�a
visinho : vizinho
viuva : vi�va
viuv�s : viuvez
vi�vez : viuvez
viuvo : vi�vo
viva�o : vivaz
vivasso : vivaz
viz�o : vis�o
vizar : visar
vizita : visita
vizitante : visitante
viz�vel : vis�vel
vizualisar : visualizar
vizualizar : visualizar
vocemess� : vossemec�
vo� : voou
v�o : voo
voses : vozes
vossemess� : vossemec�
vozeria : vozearia
vu� : voou
vuou : voou
xadresista : xadrezista
xal : xale
xalupa : chalupa
x�vena : ch�vena
x�x� : xex�
xixi : chichi
xucha : chucha
xuxa : chucha
zenite : z�nite
zig-zag : ziguezague
felecidade : felicidade
refletia-se : reflectia-se
derigia : dirigia
tr�z : tr�s
tuda : toda
di-ssermos : dissermos
analizar : analisar
quizesse : quisesse
resolve-mos : resolvemos
aprecebeu : apercebeu
consegiu : conseguiu
comumorava : comemorava
acelarada : acelerada
gazeados : gaseados
sopurt�vel : uport�vel
vaguiar : vaguear
dessisivo : decisivo
descubriu : descobriu
julguado : julgado
conosco : connosco
dire��o : direc��o
chilrrear : chilrear
perconizava : preconizava
expecial : especial
derigi : dirigi
houviu : ouviu
distra��o : distrac��o
atraz : atr�s
chilrreavam : chilreavam
campestes : campestres
igreija : igreja
espet�culo : espect�culo
recoperou : recuperou
pegem : peguem
aprecei : apressei
amontuar : amontoar
consegiu : conseguiu
apezar : apesar
acustomar : acostumar
covertor : cobertor
remor�os : remorsos
r�pidamente : rapidamente
mentir�-lhes : mentir-lhes-�
nehum : nenhum
ep�tese : hip�tese
abedica : abdica
intereces : interesses
ser-mos : ermos
esc�rneo : esc�rnio
onestas : honestas
ocurrecem : ocorressem
mediaval : medieval
escrivia : escrevia
conosco : connosco
quotodiano : quotidiano
previligiados : privilegiados
deveria-se : dever-se-ia
baseam-se : baseiam-se
atravez : atrav�s
pesquizou : pesquisou
fic�va-mos : fic�vamos
premonor : pormenor
insufecientes : insuficientes
utiliza-se : utilizasse
concelhos : conselhos
emitar : imitar
fecilidade : felicidade
desmorenou : desmoronou
soporte : uporte
�r : ar
passag�m : passagem
verdae : verdade
idependentemente : independentemente
errops : erros
prograss�o : progress�o
dificil : dif�cil
consequencia : consequ�ncia
carateriza��o : caracteriza��o
fiz�mos : fizemos
intensionais : intencionais
caracters : caracteres
ca�cter : car�cter
oera��es : opera��es
ox : os
aqules : aqueles
substituido : ubstitu�do
incluida : inclu�da
certesa : certeza
reuni�os : reuni�es
fiuco : fico
extra�veis : extra�veis
contribuiram : contribu�ram
similariedade : imilaridade
construido : constru�do
incluimos : inclu�mos
genuina : genu�na
lngas : longas
grm�ticas : gram�ticas
evoluiram : evolu�ram
estariamos : estar�amos
digitos : d�gitos
am : em
digrtamas : digramas
construidas : constru�das
dispunhamos : disp�nhamos
parentesis : par�ntesis
apresntadas : apresentadas
contrlo : controlo
caraacterizam : caracterizam
obtem-se : obt�m-se
concluimos : conclu�mos
devev : deve
ultyrapassa : ultrapassa
suget�es : ugest�es
maaiores : maiores
valors : valores
avaaliar : avaliar
listad : lista
esugest�es : ugest�es
identica : id�ntica
redundancia : redund�ncia
extraa�dos : extra�dos
par�mtros : par�metros
constituia : constitu�a
incluia : inclu�a
palavrtas : palavras
generecidade : generalidade
dicicon�rio : dicion�rio
construido : constru�do
intera��o : interac��o
re-escrita : reescrita
poderiamos : poder�amos
sub-conjunto : ubconjunto
substituido : ubstitu�do
substituida : ubstitu�da
mutio : muito
construimos : constru�mos
verificadar : verificar
esejam : ejam
deveriamos : dever�amos
extraidas : extra�das
palavraas : palavras
amis : mais
incorressemos : incorr�ssemos
dispunhamos : disp�nhamos
felx�o : flex�o
form : forma
morfs : morfes
vvalores : valores
amboas : ambos
grmaticais : gramaticais
g�nro : g�nero
agalutina��o : aglutina��o
aainda : ainda
vaamos : vaamos
Aumentaativos : Aumentativos
gaatinhos : gatinhos
mofema : morfema
g�nro : g�nero
relaativa : relativa
auamentativo : aumentativo
conjugaa��o : conjuga��o
invaari�veis : invari�veis
taamb�m : tamb�m
sintecticas : int�ticas
l�nguagem : linguagem
naturaalmente : naturalmente
hierarquicos : hier�rquicos
an�alise : an�lise
an�alise : an�lise
an�alise : an�lise
correpondente : correspondente
morfosint�ctica : morfossint�ctica
pretendessemos : pretend�ssemos
aacerca : acerca
dificil : dif�cil
constroiem : constroem
fo : for
soubessemos : oub�ssemos
abrodagem : abordagem
Entertanto : Entretanto
imporat : importa
enter : entre
vvis�vel : vis�vel
Palavvroso : Palavroso
formaaa : forma
id�nticaaa : id�ntica
resultaado : resultado
pr�-processsamento : pr�-processamento
clssifica��o : classifica��o
caracters : caracteres
preferm : preferem
podesse : pudesse
copmo : como
constroi : constr�i
parentesis : par�ntesis
identica : id�ntica
impessoaal : impessoal
xemplo : exemplo
dlisti��o : distin��o
contrlo : controlo
uam : uma
exemmplo : exemplo
validadda : validada
aqualquer : qualquer
compreen��o : compreens�o
compnentes : componentes
arl�m : al�m
respresentam : representam
pr�tica : pr�tica
outrs : outras
veirficados : verificados
dific�l : dif�cil
masrca : marca
sucessivvamente : ucessivamente
genero : g�nero
oprigem : origem
g�nro : g�nero
anaalisado : analisado
v�lidaas : v�lidas
n�ao : n�o
t�ao : t�o
traansformaar : transformar
m�ao : m�o
saberiamos : aber�amos
substitu�ndo : ubstituindo
aasociadas : associadas
braqueiro : barqueiro
identico : id�ntico
n�oa : n�o-a
detrminada : determinada
abeviaturas : abreviaturas
dtio : dito
paravras : palavras
prvis�veis : pevis�veis
rdical : radical
outrso : outros
excluida : exclu�da
probabiliade : probabilidade
passivante : apassivante
uam : uma
guarda-sois : guarda-s�is
toamndo : tomando
desenvvolvimento : desenvolvimento
preeenchimento : preenchimento
protugu�s : portug�s
imposss�vel : imposs�vel
constroi-se : constr�i-se
milisegundos : milissegundos
resultdos : resultados
ctgorias : categorias
soubermso : oubermos
incluimos : inclu�mos
concluimos : conclu�mos
caracter : car�cter
pror�mos : procuramos
rsultados : resultados
pis : pois
obtiv�mos : obtivemos
esperariamos : esperar�amos
constactar : constatar
romanso : romanos
detrminado : determinado
equilibrio : equil�brio
bastave : bastava
re-escrever : reescrever
aparecerrem : aparecerem
possuimos : possu�mos
rro : erro
igonrado : ignorado
limitaamos : limitamos
benificia : beneficia
fiz�mos : fizemos
mara : para
morfol�pgico : morfol�gico
sre : er
aa : a
paalavroso : palavroso
aaos : aos
conp�em : comp�em
eventuaalmente : eventualmente
sequncialmente : equencialmente
gen�ricamente : genericamente
vaamos : vamos
dixer : dizer
aaplica��o : aplica��o
usaamos : usamos
aa : a
aao : ao
mutio : muito
aacrescentar : acrescentar
justifcar-se : justificar-se
maaior : maior
maai�sculas : mai�sculas
opera��ao : opera��o
correctro : correcto
trigraama : trigrama
sugst�es : ugest�es
recorremos-nos : recorremo-nos
quaais : quais
entraamos : entramos
aa : a
substituida : ubstitu�da
verificaamos : verificamos
recursus : recursos
na�o : n�o
implicitaamnte : implicitamente
caap�tulo : cap�tulo
suaa : ua
daa : da
aplicaa��o : aplica��o
funcionarlidade : funcionalidade
plataaformas : plataformas
n�ao : n�o
aainda : ainda
�ncio : �nico
an�alise : an�lise
vaai : vai
procuraamos : procuramos
usadno : usando
dosi : dois
apanhaar : apanhar
aabordagem : abordagem
rgras : regras
an�alise : an�lise
concluimos : conclu�mos
� : �
�rvore : �rvore
acessas : acesas
actividadees : actividades
Administar��o : Administra��o
Agosot : Agosto
alg�m : algu�m
algorimto : algoritmo
amplamante : amplamente
aolgoritmos : algoritmos
aproxiam��o : aproxima��o
arrajemos : arranjemos
avivizinham : avizinham
Barsil : Brasil
Bibliteca : Biblioteca
Bilioteca : Biblioteca
bolachinas : bolachinhas
brincadira : brincadeira
Camarados : Camaradas
candiadatos : candidatos
candiadaturas : candidaturas
candiadturas : candidaturas
caracteriscas : caracter�sticas
cedererem : cederem
Chesfes : Chefes
cinetificas : cient�ficas
cobe : coube
comec� : come�a
computadres : computadores
comtempla : contempla
conguir : conseguir
constitudo : constitu�do
Contacos : Contactos
contrbuir : contribuir
contrpartida : contrapartida
contunar : continuar
contunar : continuar
correpondencia : correspond�ncia
corres-pond�ncia : correspond�ncia
correspondecia : correspond�ncia
correspondenccia : correspond�ncia
cultuarais : culturais
demaais : demais
demonstar��es : demonstra��es
desenvimento : desenvolvimento
desenvovimento : desenvolvimento
desulpem : desculpem
dificukdades : dificuldades
diger : dizer
Direcc��o : Direc��o
discus�o : discuss�o
disses : disse
divlugue : divulgue
divugar : divulgar
domnos : donos
doutirado : doutorado
dsenvolvimento : desenvolvimento
eatarem : estarem
econtra : encontra
ecosistemas : ecossistemas
eferendo : referendo
Efificio : Edif�cio
elega��o : delega��o
emnos : menos
enconbtra : encontra
ENCONTA-SE : ENCONTRA-SE
ENCONTAM-SE : ENCONTRAM-SE
encontar : encontrar
Epediente : Expediente
escever : escrever
espirrito : esp�rito
esssa : essa
establecer : estabelecer
estajam : estejam
estass : estas
exeplares : exemplares
exist�mcia : exist�ncia
exitencia : exist�ncia
experiancia : experi�ncia
Extrordinaria : Extraordin�ria
favor�aveis : favor�veis
fazere : fazer
fiabiliade : fiabilidade
fianciamento : financiamento
fidalgias : fidalguias
flutuaa��es : flutua��es
fomato : formato
frustados : frustrados
gabinte : gabinete
garatir : garantir
graande : grande
Homesns : Homens
idea : ideia
ideiua : ideia
imeditamente : imediatamente
implemenetam : implementam
impossival : imposs�vel
imputads : imputados
inauguardo : inaugurado
inciar : iniciar
inciativas : iniciativas
incrito : inscrito
Indistrial : Industrial
indiviseis : indivis�veis
indivuduais : individuais
infoma��es : informa��es
inforam��o : informa��o
informmatica : inform�tica
inscever-se : inscrever-se
instituo��o : institui��o
institutoas : institutos
interesado : interessado
interesados : interessados
interesante : interessante
interssado : interessado
Intitui��es : Institui��es
investig��o : investiga��o
iscuss�o : discuss�o
isoladamnete : isoladamente
itesm : itens
la�amento : lan�amento
leventado : levantado
liagassem : ligassem
libera��o : liberta��o
licancas : licen�as
licenciatua : licenciatura
LUMIMOSA : LUMINOSA
malata : malta
mandase : mandasse
mandassess : mandasses
mebros : membros
memso : mesmo
mewses : meses
momemto : momento
Multmedia : Multim�dia
mundan�a : mudan�a
muuito : muito
n�o : n�o
naao : n�o
nais : mais
natale : natal
necesitar : necessitar
necess�io : necess�rio
nemhuma : nenhuma
nomeadamentem : nomeadamente
nomeadamento : nomeadamente
nomedamente : nomeadamente
numca : nunca
nuneros : n�meros
oferecen : oferecem
optimisitico : optim�stico
organigrams : organigramas
orginador : originador
ortigr�fica : ortogr�fica
ortigr�fico : ortogr�fico
ourtra : outra
panhado : apanhado
part�pio : partic�pio
partica : pratica
partilihar : partilhar
pekla : pela
perceisamente : precisamente
perguntaou : perguntou
persectivas : perspectivas
pesssoa : pessoa
pesssoal : pessoal
podera : poder�
podiamo : pod�amos
podria : poderia
porgrama : programa
poss-te : posso-te
posss�vel : poss�vel
possso : posso
postall : postal
pprimeiras : primeiras
prblemas : problemas
preceso : preciso
previsvel : previs�vel
princio : princ�pio
probelma : problema
procedimeto : procedimento
processamneto : processamento
produtivade : produtividade
profisssional : profissional
prograssos : progressos
prolemas : problemas
proposcoes : propor��es
publica�a�es : publica��es
Qando : Quando
qaulidade : qualidade
quarquer : qualquer
qui : aqui
qunto : quanto
qye : que
recional : racional
recuros : recursos
relacinado : relacionado
relaizar : realizar
repetui-se : repetiu-se
repons�veis : respons�veis
reponsavel : respons�vel
respectvos : respectivos
responsabnilidade : responsabilidade
sacricios : acrif�cios
Segeum-se : Seguem-se
segir : eguir
seguines : eguintes
selaec��o : elec��o
senytido : entido
serai : erei
Sevi�o : Servi�o
sevi�os : ervi�os
sguerras : guerras
Sgundo : Segundo
sintactica : int�ctica
situ��o : itua��o
sugest�oes : ugest�es
ta�cas : ta�as
tadu��es : tradu��es
tecnogia : tecnologia
telvez : talvez
temnho : tenho
testest : testes
tiveese : tivesse
tranporte : transporte
trentem : tentem
�ultima : �ltima
uiniversitarios : universit�rios
Unversidadese : Universidades
uperiores : uperiores
Utilizdores : Utilizadores
van�ar : avan�ar
verique : verifique
vers�o : vers�o
vers�O : vers�o
vwerificar : verificar
wais : vais
experiancia : experi�ncia
� : �
�rvore : �rvore
abanbonar : abandonar
acessas : acesas
actividadees : actividades
Administar��o : Administra��o
Agosot : Agosto
alg�m : algu�m
algorimto : algoritmo
amplamante : amplamente
aolgoritmos : algoritmos
aproxiam��o : aproxima��o
arrajemos : arranjemos
avivizinham : avizinham
Barsil : Brasil
Bibliteca : Biblioteca
Bilioteca : Biblioteca
bolachinas : bolachinhas
brincadira : brincadeira
Camarados : Camaradas
candiadatos : candidatos
candiadaturas : candidaturas
candiadturas : candidaturas
caracteriscas : caracter�sticas
cedererem : cederem
Chesfes : Chefes
cinetificas : cient�ficas
cobe : coube
comec� : come�a
computadres : computadores
comtempla : contempla
conguir : conseguir
constitudo : constitu�do
Contacos : Contactos
contrbuir : contribuir
contrpartida : contrapartida
contunar : continuar
contunar : continuar
correpondencia : correspond�ncia
corres-pond�ncia : correspond�ncia
correspondecia : correspond�ncia
correspondenccia : correspond�ncia
cultuarais : culturais
demaais : demais
demonstar��es : demonstra��es
desenvimento : desenvolvimento
desenvovimento : desenvolvimento
desulpem : desculpem
dificukdades : dificuldades
diger : dizer
Direcc��o : Direc��o
discus�o : discuss�o
disses : disse
divlugue : divulgue
divugar : divulgar
domnos : donos
doutirado : doutorado
dsenvolvimento : desenvolvimento
eatarem : estarem
econtra : encontra
ecosistemas : ecossistemas
edi'icio	edif�cio : f
eferendo : referendo
Efificio : Edif�cio
elega��o : delega��o
emnos : menos
enconbtra : encontra
ENCONTA-SE : ENCONTRA-SE
ENCONTAM-SE : ENCONTRAM-SE
encontar : encontrar
Epediente : Expediente
escever : escrever
espirrito : esp�rito
esssa : essa
establecer : estabelecer
estajam : estejam
estass : estas
exeplares : exemplares
exist�mcia : exist�ncia
exitencia : exist�ncia
experiancia : experi�ncia
Extrordinaria : Extraordin�ria
favor�aveis : favor�veis
fazere : fazer
fiabiliade : fiabilidade
fianciamento : financiamento
fidalgias : fidalguias
flutuaa��es : flutua��es
fomato : formato
frustados : frustrados
gabinte : gabinete
garatir : garantir
graande : grande
Homesns : Homens
idea : ideia
ideiua : ideia
imeditamente : imediatamente
implemenetam : implementam
impossival : imposs�vel
imputads : imputados
inauguardo : inaugurado
inciar : iniciar
inciativas : iniciativas
incrito : inscrito
Indistrial : Industrial
indiviseis : indivis�veis
indivuduais : individuais
infoma��es : informa��es
inforam��o : informa��o
informmatica : inform�tica
inscever-se : inscrever-se
instituo��o : institui��o
institutoas : institutos
interesado : interessado
interesados : interessados
interesante : interessante
interssado : interessado
Intitui��es : Institui��es
investig��o : investiga��o
iscuss�o : discuss�o
isoladamnete : isoladamente
itesm : itens
la�amento : lan�amento
leventado : levantado
liagassem : ligassem
libera��o : liberta��o
licancas : licen�as
licenciatua : licenciatura
LUMIMOSA : LUMINOSA
malata : malta
mandase : mandasse
mandassess : mandasses
mebros : membros
memso : mesmo
mewses : meses
momemto : momento
Multmedia : Multim�dia
mundan�a : mudan�a
muuito : muito
n�o : n�o
naao : n�o
nais : mais
natale : natal
necesitar : necessitar
necess�io : necess�rio
nemhuma : nenhuma
nomeadamentem : nomeadamente
nomeadamento : nomeadamente
nomedamente : nomeadamente
numca : nunca
nuneros : n�meros
oferecen : oferecem
optimisitico : optim�stico
organigrams : organigramas
orginador : originador
ortigr�fica : ortogr�fica
ortigr�fico : ortogr�fico
ourtra : outra
panhado : apanhado
part�pio : partic�pio
partica : pratica
partilihar : partilhar
pekla : pela
perceisamente : precisamente
perguntaou : perguntou
persectivas : perspectivas
pesssoa : pessoa
pesssoal : pessoal
podera : poder�
podiamo : pod�amos
podria : poderia
porgrama : programa
poss-te : posso-te
posss�vel : poss�vel
possso : posso
postall : postal
pprimeiras : primeiras
prblemas : problemas
preceso : preciso
previsvel : previs�vel
princio : princ�pio
probelma : problema
procedimeto : procedimento
processamneto : processamento
produtivade : produtividade
profisssional : profissional
prograssos : progressos
prolemas : problemas
proposcoes : propor��es
publica�a�es : publica��es
Qando : Quando
qaulidade : qualidade
quarquer : qualquer
qui : aqui
qunto : quanto
qye : que
recional : racional
recuros : recursos
relacinado : relacionado
relaizar : realizar
repetui-se : repetiu-se
repons�veis : respons�veis
reponsavel : respons�vel
respectvos : respectivos
responsabnilidade : responsabilidade
sacricios : acrif�cios
Segeum-se : Seguem-se
segir : eguir
seguines : eguintes
selaec��o : elec��o
senytido : entido
serai : erei
Sevi�o : Servi�o
sevi�os : ervi�os
sguerras : guerras
Sgundo : Segundo
sintactica : int�ctica
situ��o : itua��o
sugest�oes : ugest�es
ta�cas : ta�as
tadu��es : tradu��es
tecnogia : tecnologia
telvez : talvez
temnho : tenho
testest : testes
tiveese : tivesse
tranporte : transporte
trentem : tentem
�ultima : �ltima
uiniversitarios : universit�rios
Unversidadese : Universidades
uperiores : uperiores
Utilizdores : Utilizadores
van�ar : avan�ar
verique : verifique
vers�o : vers�o
vers�O : vers�O
vwerificar : verificar
wais : vais
experiancia : experi�ncia
agradego : agrade�o
atravis : atrav�s
caracterxstica : caracter�stica
Certificaxxo : Certifica��o
Cientmfica : Cient�fica
Cientmficas : Cient�ficas
Cixncia : Ci�ncia
Co-financiamento : Co-financiamento
compatmveis : compat�veis
Comunicagco : Comunica��o
Comunicaxxo : Comunica��o
Comxrcio : Com�rcio
Conduxxo : Condu��o
dimensxes : dimens�es
disponmvel : dispon�vel
DISPOSIGCO : DISPOSI��O
Dixrio : Di�rio
DOCUMENTAGCO : DOCUMENTA��O
Documentaxxo : Documenta��o
Econxmica : Econ�mica
Econxmico : Econ�mico
Educaxxo : Educa��o
ELECTRXNICA : ELECTR�NICA
elegmveis : eleg�veis
Elxctricos : El�ctricos
repxblica : rep�blica
esforgo : esfor�o
esforxo : esfor�o
especmfica : espec�fica
especmficas : espec�ficas
espect-aculo : espect�culo
estaxxo : esta��o
estratxgia : estrat�gia
estx : est�
exercmcio : exerc�cio
Expansxo : Expans�o
EXPERIJNCIA : EXPERI�NCIA
finanxas : finan�as
formaxxo : forma��o
geraxxo : gera��o
indxstria : ind�stria
INFORMAGCO : INFORMA��O
informaxxo : informa��o
Informxtica : Inform�tica
inmcio : in�cio
inquisigco : inquisi��o
jurxdica : jur�dica
Laboratxrio : Laborat�rio
LABORATXRIOS : LABORAT�RIOS
manutenxxo : manuten��o
Marxtima : Mar�tima
Menxxes : Men��es
Ministxrio : Minist�rio
mmnima : m�nima
mmnimo : m�nimo
Modernizaxxo : Moderniza��o
Mudanxa : Mudan�a
Multimidia : Multim�dia
Mxdias : M�dias
nmvel : n�vel
notxcia : not�cia
Notxcias : Not�cias
nxcleos : n�cleos
nxmero : n�mero
nxmeros : n�meros
operarx : operar�
Opinixo : Opini�o
OPTOELECTRXNICA : OPTOELECTR�NICA
organizaxxo : organiza��o
orxamento : or�amento
orxamentos : or�amentos
permodos : per�odos
perxodo : per�odo
Politxcnico : Polit�cnico
polmtica : pol�tica
polmticas : pol�ticas
Polxtica : Pol�tica
prejumzo : preju�zo
presenxa : presen�a
Proibixxo : Proibi��o
Protecxxo : Protec��o
protxtipo : prot�tipo
prsxima : pr�xima
publicaxxes : publica��es
publicaxxo : publica��o
Publimxdia : Publim�dia
pxblico : p�blico
pxs-graduada : p�s-graduada
recomexaram : recome�aram
Reestruturaxxo : Reestrutura��o
referxncia : refer�ncia
reforxo : refor�o
regixo : regi�o
responsxveis : respons�veis
Semanxrio : Seman�rio
sequjncia : equ�ncia
servixo : ervi�o
servixos : ervi�os
Smmbolos : S�mbolos
smmbolos : s�mbolos
subsmdios : subs�dios
SUMXRIO : SUM�RIO
sxo : s�o
tambxm : tamb�m
telecomunicaxxes : telecomunica��es
telefxnica : telef�nica
terga-feira : ter�a-feira
TICNICA : T�CNICA
xrea : �rea
xreas : �reas
felecidade : felicidade
refletia-se : reflectia-se
derigia : dirigia
tr�z : tr�s
tuda : toda
di-ssermos : dissermos
analizar : analisar
quizesse : quisesse
resolve-mos : resolvemos
aprecebeu : apercebeu
consegiu : conseguiu
comumorava : comemorava (??)
acelarada : acelerada
gazeados : gaseados (?)
sopurt�vel : uport�vel
vaguiar : vaguear
dessisivo : decisivo
descubriu : descobriu
julguado : julgado
conosco : connosco
dire��o : direc��o
chilrrear : chilrear
perconizava : preconizava
expecial : especial
derigi : dirigi
houviu : ouviu
distra��o : distrac��o
atraz : atr�s
chilrreavam : chilreavam
campestes : campestres
igreija : igreja
espet�culo : espect�culo
recoperou : recuperou
pegem : peguem
aprecei : apressei
amontuar : amontoar
consegiu : conseguiu
apezar : apesar
acustomar : acostumar
covertor : cobertor
remor�os : remorsos
r�pidamente : rapidamente
mentir�-lhes : mentir-lhes-�
nehum : nenhum
ep�tese : hip�tese
abedica : abdica
intereces : interesses
ser-mos : ermos
esc�rneo : esc�rnio
onestas : honestas
ocurrecem : ocorressem
mediaval : medieval
escrivia : escrevia
conosco : connosco
quotodiano : quotidiano
previligiados : privilegiados
express�veis : exprim�veis
deveria-se : dever-se-ia
baseam-se : baseiam-se
atravez : atrav�s
pesquizou : pesquisou
fic�va-mos : fic�vamos
premonor : pormenor
insufecientes : insuficientes
utiliza-se : utilizasse
concelhos : conselhos
emitar : imitar
fecilidade : felicidade
desmorenou : desmoronou
soporte : uporte
�r : ar
passag�m : passagem
verdae : verdade
idependentemente : independentemente
errops : erros
prograss�o : progress�o
dificil : dif�cil
consequencia : consequ�ncia
carateriza��o : caracteriza��o
fiz�mos : fizemos
intensionais : intencionais
caracters : caracteres
ca�cter : car�cter
oera��es : opera��es
ox : os
aqules : aqueles
substituido : ubstitu�do
incluida : inclu�da
certesa : certeza
reuni�os : reuni�es
fiuco : fico
extra�veis : extra�veis
contribuiram : contribu�ram
similariedade : imilaridade
construido : constru�do
incluimos : inclu�mos
genuina : genu�na
lngas : longas
grm�ticas : gram�ticas
evoluiram : evolu�ram
estariamos : estar�amos
digitos : d�gitos
am : em
digrtamas : digramas
construidas : constru�das
dispunhamos : disp�nhamos
parentesis : par�ntesis
apresntadas : apresentadas
contrlo : controlo
caraacterizam : caracterizam
obtem-se : obt�m-se
concluimos : conclu�mos
devev : deve
ultyrapassa : ultrapassa
suget�es : ugest�es
maaiores : maiores
valors : valores
avaaliar : avaliar
listad : lista
esugest�es : ugest�es
identica : id�ntica
redundancia : redund�ncia
extraa�dos : extra�dos
par�mtros : par�metros
constituia : constitu�a
incluia : inclu�a
palavrtas : palavras
generecidade : generalidade
dicicon�rio : dicion�rio
construido : constru�do
intera��o : interac��o
re-escrita : reescrita
poderiamos : poder�amos
sub-conjunto : ubconjunto
substituido : ubstitu�do
substituida : ubstitu�da
mutio : muito
construimos : constru�mos
verificadar : verificar
esejam : ejam
deveriamos : dever�amos
extraidas : extra�das
palavraas : palavras
amis : mais
incorressemos : incorr�ssemos
dispunhamos : disp�nhamos
felx�o : flex�o
form : forma
morfs : morfes
vvalores : valores
amboas : ambos
grmaticais : gramaticais
g�nro : g�nero
agalutina��o : aglutina��o
aainda : ainda
vaamos : vaamos
Aumentaativos : Aumentativos
gaatinhos : gatinhos
mofema : morfema
g�nro : g�nero
relaativa : relativa
auamentativo : aumentativo
conjugaa��o : conjuga��o
invaari�veis : invari�veis
taamb�m : tamb�m
sintecticas : int�ticas
l�nguagem : linguagem
naturaalmente : naturalmente
hierarquicos : hier�rquicos
an�alise : an�lise
an�alise : an�lise
an�alise : an�lise
correpondente : correspondente
morfosint�ctica : morfossint�ctica
pretendessemos : pretend�ssemos
aacerca : acerca
dificil : dif�cil
constroiem : constroem
fo : for
soubessemos : oub�ssemos
abrodagem : abordagem
Entertanto : Entretanto
imporat : importa
enter : entre
vvis�vel : vis�vel
Palavvroso : Palavroso
formaaa : forma
id�nticaaa : id�ntica
resultaado : resultado
pr�-processsamento : pr�-processamento
clssifica��o : classifica��o
felecidade : felicidade
refletia-se : reflectia-se
derigia : dirigia
tr�z : tr�s
tuda : toda
di-ssermos : dissermos
analizar : analisar
quizesse : quisesse
resolve-mos : resolvemos
aprecebeu : apercebeu
consegiu : conseguiu
comumorava : comemorava 
acelarada : acelerada
gazeados : gaseados
sopurt�vel : uport�vel
vaguiar : vaguear
dessisivo : decisivo
descubriu : descobriu
julguado : julgado
conosco : connosco
dire��o : direc��o
chilrrear : chilrear
perconizava : preconizava
expecial : especial
derigi : dirigi
houviu : ouviu
distra��o : distrac��o
atraz : atr�s
chilrreavam : chilreavam
campestes : campestres
igreija : igreja
espet�culo : espect�culo
recoperou : recuperou
pegem : peguem
aprecei : apressei
amontuar : amontoar
consegiu : conseguiu
apezar : apesar
acustomar : acostumar
covertor : cobertor
remor�os : remorsos
r�pidamente : rapidamente
mentir�-lhes : mentir-lhes-�
nehum : nenhum
ep�tese : hip�tese
abedica : abdica
intereces : interesses
ser-mos : ermos
esc�rneo : esc�rnio
onestas : honestas
ocurrecem : ocorressem
mediaval : medieval
escrivia : escrevia
conosco : connosco
quotodiano : quotidiano
previligiados : privilegiados
deveria-se : dever-se-ia
baseam-se : baseiam-se
atravez : atrav�s
pesquizou : pesquisou
fic�va-mos : fic�vamos
premonor : pormenor
insufecientes : insuficientes
utiliza-se : utilizasse
concelhos : conselhos
emitar : imitar
fecilidade : felicidade
desmorenou : desmoronou
soporte : uporte
�r : ar
passag�m : passagem
verdae : verdade
idependentemente : independentemente
errops : erros
ara : p+para
prograss�o : progress�o
dificil : dif�cil
consequencia : consequ�ncia
carateriza��o : caracteriza��o
fiz�mos : fizemos
intensionais : intencionais
caracters : caracteres
ca�cter : car�cter
oera��es : opera��es
ox : os
aqules : aqueles
substituido : ubstitu�do
incluida : inclu�da
certesa : certeza
reuni�os : reuni�es
fiuco : fico
extra�veis : extra�veis
contribuiram : contribu�ram
similariedade : imilaridade
construido : constru�do
incluimos : inclu�mos
genuina : genu�na
lngas : longas
grm�ticas : gram�ticas
evoluiram : evolu�ram
estariamos : estar�amos
digitos : d�gitos
am : em
digrtamas : digramas
construidas : constru�das
dispunhamos : disp�nhamos
parentesis : par�ntesis
apresntadas : apresentadas
contrlo : controlo
caraacterizam : caracterizam
obtem-se : obt�m-se
concluimos : conclu�mos
devev : deve
ultyrapassa : ultrapassa
suget�es : ugest�es
maaiores : maiores
valors : valores
avaaliar : avaliar
listad : lista
esugest�es : ugest�es
identica : id�ntica
redundancia : redund�ncia
extraa�dos : extra�dos
par�mtros : par�metros
constituia : constitu�a
incluia : inclu�a
palavrtas : palavras
generecidade : generalidade
dicicon�rio : dicion�rio
construido : constru�do
intera��o : interac��o
re-escrita : reescrita
poderiamos : poder�amos
sub-conjunto : ubconjunto
substituido : ubstitu�do
substituida : ubstitu�da
mutio : muito
construimos : constru�mos
verificadar : verificar
esejam : ejam
deveriamos : dever�amos
extraidas : extra�das
palavraas : palavras
amis : mais
incorressemos : incorr�ssemos
dispunhamos : disp�nhamos
felx�o : flex�o
form : forma
morfs : morfes
vvalores : valores
amboas : ambos
grmaticais : gramaticais
g�nro : g�nero
agalutina��o : aglutina��o
aainda : ainda
vaamos : vaamos
Aumentaativos : Aumentativos
gaatinhos : gatinhos
mofema : morfema
g�nro : g�nero
relaativa : relativa
auamentativo : aumentativo
conjugaa��o : conjuga��o
invaari�veis : invari�veis
taamb�m : tamb�m
sintecticas : int�ticas
l�nguagem : linguagem
naturaalmente : naturalmente
hierarquicos : hier�rquicos
an�alise : an�lise
an�alise : an�lise
an�alise : an�lise
correpondente : correspondente
morfosint�ctica : morfossint�ctica
pretendessemos : pretend�ssemos
aacerca : acerca
dificil : dif�cil
constroiem : constroem
fo : for
soubessemos : oub�ssemos
abrodagem : abordagem
Entertanto : Entretanto
imporat : importa
enter : entre
vvis�vel : vis�vel
Palavvroso : Palavroso
formaaa : forma
id�nticaaa : id�ntica
resultaado : resultado
pr�-processsamento : pr�-processamento
clssifica��o : classifica��o
caracters : caracteres
preferm : preferem
podesse : pudesse
copmo : como
constroi : constr�i
parentesis : par�ntesis
identica : id�ntica
impessoaal : impessoal
xemplo : exemplo
dlisti��o : distin��o
contrlo : controlo 
uam : uma
exemmplo : exemplo
validadda : validada
aqualquer : qualquer
compreen��o : compreens�o
compnentes : componentes
arl�m : al�m
respresentam : representam
pr�tica : pr�tica
outrs : outras
veirficados : verificados
dific�l : dif�cil
masrca : marca
sucessivvamente : ucessivamente
genero : g�nero
oprigem : origem
g�nro : g�nero
anaalisado : analisado
v�lidaas : v�lidas
n�ao : n�o
t�ao : t�o
traansformaar : transformar
m�ao : m�o
saberiamos : aber�amos
substitu�ndo : ubstituindo
aasociadas : associadas
braqueiro : barqueiro
identico : id�ntico
n�oa : n�o-a 
detrminada : determinada
abeviaturas : abreviaturas
dtio : dito
paravras : palavras
prvis�veis : pevis�veis
rdical : radical
outrso : outros
excluida : exclu�da
probabiliade : probabilidade
passivante : apassivante
uam : uma
guarda-sois : guarda-s�is
toamndo : tomando
desenvvolvimento : desenvolvimento
preeenchimento : preenchimento
protugu�s : portug�s
imposss�vel : imposs�vel
constroi-se : constr�i-se
milisegundos : milissegundos
resultdos : resultados
ctgorias : categorias
soubermso : oubermos
incluimos : inclu�mos
concluimos : conclu�mos
caracter : car�cter
pror�mos : procuramos
rsultados : resultados
pis : pois 
obtiv�mos : obtivemos
esperariamos : esperar�amos
constactar : constatar
romanso : romanos
detrminado : determinado
equilibrio : equil�brio
bastave : bastava
re-escrever : reescrever
aparecerrem : aparecerem
possuimos : possu�mos
rro : erro
igonrado : ignorado
limitaamos : limitamos
benificia : beneficia
fiz�mos : fizemos
mara : para
morfol�pgico : morfol�gico
sre : er
aa : a
paalavroso : palavroso
aaos : aos
conp�em : comp�em
eventuaalmente : eventualmente 
sequncialmente : equencialmente
gen�ricamente : genericamente
vaamos : vamos
dixer : dizer
aaplica��o : aplica��o
usaamos : usamos
aa : a
aao : ao
mutio : muito
aacrescentar : acrescentar
justifcar-se : justificar-se
maaior : maior
maai�sculas : mai�sculas
opera��ao : opera��o
correctro : correcto
trigraama : trigrama
sugst�es : ugest�es
recorremos-nos : recorremo-nos
quaais : quais
entraamos : entramos
aa : a
substituida : ubstitu�da
verificaamos : verificamos
recursus : recursos
na�o : n�o
implicitaamnte : implicitamente
caap�tulo : cap�tulo
suaa : ua
daa : da
aplicaa��o : aplica��o
funcionarlidade : funcionalidade
plataaformas : plataformas
n�ao : n�o
aainda : ainda
�ncio : �nico
an�alise : an�lise
vaai : vai
procuraamos : procuramos
usadno : usando
dosi : dois
apanhaar : apanhar
aabordagem : abordagem
rgras : regras
an�alise : an�lise
Marital : conclu�mos : concluimosMarrial
Nacionality : Nationality
Adress : Address
peryod : period
Engennering : Engineering
inteligence : intelligence
enphasis : emphasis
mophological : morphological
dictionnaries : dictionaries
chscking : checking
gramatic : grammatic
dictionnary : dictionary
ab�boda : ab�bada
absti-me : abstive-me
abstrato : abstracto
ace�o : acesso
acelarar : acelerar
�cerca : acerca
acer��o : asser��o
acessabilidade : acessibilidade
aceza : acesa
acezo : aceso
acord�os : ac�rd�os
a�oreano : a�oriano
a�ossiar : associar
actris : actriz
adamastor : Adamastor
adeuzinho : adeusinho
Adotamos : Adoptamos
adotar : adoptar
adquir�-los : adquiri-los
a�rio : a�reo
aero-clube : aeroclube
ageitar : ajeitar
agonisar : agonizar
agradaveis : agrad�veis
ajuisar : ajuizar
album : �lbum
albuns : �lbuns
alerjia : alergia
alfasema : alfazema
alforje : alforge
algasarra : algazarra
alger�s : algeroz
algoses : algozes
alissiante : aliciante
alissiar : aliciar
alizar : alisar
alumeia : alumia
�manh� : amanh�
�mbigua : amb�gua
�mbiguidade : ambiguidade
amenisar : amenizar
analizador : analisador
analizar : analisar
an�lize : an�lise
�ncia : �nsia
ansestral : ancestral
ansestralidade : ancestralidade
ansiolitico : ansiol�tico
ansiul�tico : ansiol�tico
antig�idade : antiguidade
aporado : apurado
aporar : apurar
aporteguesamento : aportuguesamento
aporteguesar : aportuguesar
aquem : aqu�m
�quem : aqu�m
aqu� : aqui
arborisar : arborizar
arid�s : aridez
armazem : armaz�m
armazens : armaz�ns
arquiteto : arquitecto
Arquitetura : Arquitectura
arrange : arranje
arrangei : arranjei
arrangemos : arranjemos
arranges : arranjes
arrazado : arrasado
arrazar : arrasar
arrea : arreia
arregassado : arrega�ado
arregassar : arrega�ar
artf�cio : artif�cio
as�fama : az�fama
ascen��o : ascens�o
aseite : azeite
asenha : azenha
asia : azia
asimute : az�mute
ass�s : assaz
asse�o : acesso
assers�o : asser��o
assesso : acesso
Assessoria : Acessoria
assossiar : associar
ass�car : a��car
assucena : a�ucena
atabalhuar : atabalhoar
atarrachar : atarraxar
aterrorisar : aterrorizar
atl�ctico : atl�tico
atrai��e : atrai�oe
atraissoar : atrai�oar
atraiste : atra�ste
atraves : atrav�s
atravez : atrav�s
atraz : atr�s
atrazar : atrasar
atrazo : atraso
atribuia : atribu�a
atribuiam : atribu�am
atribuiamos : atribu�amos
atribuimos : atribu�mos
atribuiram : atribu�ram
atribu�rei : atribuirei
atribuirem : atribu�rem
atribu�remos : atribuiremos
atribuitivo : atributivo
atriz : actriz
atual : actual
audio-visual : audiovisual
Autoestradas : Auto-estradas
automatisa��o : automatiza��o
autorisar : autorizar
autosuspens�o : auto-suspens�o
autosuspenso : auto-suspenso
autosustenta��o : auto-sustenta��o
averigue : averig�e
avizado : avisado
avizar : avisar
avizo : aviso
az�ago : aziago
azuleijo : azulejo
azuleijos : azulejos
babozeira : baboseira
babuseira : baboseira
bacharlato : bacharelato
bactriana : bacteriana
badagaio : vadagaio
balisa : baliza
banderilha : bandarilha
baptisar : baptizar
baqueteriano : bacteriano
barcassa : barca�a
barr�co : barroco
barr�cos : barrocos
basar : bazar
bas�fia : baz�fia
batizar : baptizar
baze : base
b�be : beb�
b�b� : beb�
belesa : beleza
bemequer : bem-me-quer
Bemfica : Benfica
ben��o : b�n��o
benificia��es : beneficia��es
benificiar : beneficiar
benquerer : bem-querer
benvindo : bem-vindo
berbulha : borbulha
bisarro : bizarro
bisexto : bissexto
bisexual : bissexual
bisexualidade : bissexualidade
bissectris : bissectriz
bissessual : bissexual
bissetriz : bissectriz
bocage : Bocage
boia : b�ia
boiam : b�iam
boie : b�ie
boiem : b�iem
boio : b�io
bolir : bulir
bonus : b�nus
borbolha : borbulha
borbolhar : borbulhar
braza : brasa
brazil : Brasil
bregeiro : brejeiro
briza : brisa
bruxelas : Bruxelas
bujiar : bugiar
burborinho : burburinho
busina : buzina
cafeina : cafe�na
cafeseiro : cafezeiro
caichilho : caixilho
caiem : caem
caimbras : c�ibras
ca�mbras : c�ibras
ca�ndo : caindo
ca�r : cair
ca�r-lhe : cair-lhe
caira : ca�ra
ca�r� : cair�
cairam : ca�ram
ca�r�o : cair�o
ca�r�s : cair�s
ca�rdes : cairdes
cairem : ca�rem
ca�remos : cairemos
caires : ca�res
cairmos : ca�rmos
ca�rmos : cairmos
calc�reo : calc�rio
c�lis : c�lice
calsar : cal�ar
calvice : calv�cie
campa�nha : campainha
campi�o : campe�o
can�ar : cansar
can�aso : cansa�o
can�asso : cansa�o
cans�o : can��o
c�osinho : c�ozinho
c�oz�nho : c�ozinho
cap�s : capaz
captivo : cativo
car�cteres : caracteres
carangueijo : caranguejo
carateres : caracteres
carcassa : carca�a
cardio-vascular : cardiovascular
Carissimos : Car�ssimos
carlos : Carlos
carmos : Carmos
carrocel : carrossel
carroucel : carrossel
cartom�ncia : cartomancia
casc�vel : cascavel
cassarola : ca�arola
catalizar : catalisar
cat�lize : cat�lise
catura : captura
causad�aco : caus�dico
c�ra : cera
c�rca : cerca
c�rca : cerca
cerim�nia : cerim�nia
cerralheiro : erralheiro
cert�me : certame
certesa : certeza
cet�sseo : cet�ceo
ceu : c�u
cezariana : cesariana
chaile : xaile
chale : xale
chapeu : chap�u
chasso : cha�o
chatiar : chatear
chatiava : chateava
chatisse : chatice
chech� : xex�
ch�ch� : xex�
cheinho : cheiinho
che�nho : cheiinho
che�ssimo : chei�ssimo
ch�cara : x�cara
chuxa : chucha
cicatrisar : cicatrizar
cicratisar : cicatrizar
cintaxe : intaxe
ciume : ci�me
claresa : clareza
classismo : classicismo
cobissa : cobi�a
coca-cola : Coca-cola
c�dia : c�dea
colectivisa��o : colectiviza��o
coletiviza��o : colectiviza��o
colijir : coligir
colin�ria : culin�ria
colizeu : coliseu
comb�io : comboio
comperativa : cooperativa
complementariedade : complementaridade
compreen��o : compreens�o
comprendeu : compreendeu
compurscar : conspurcar
comumente : comummente
concenso : consenso
concluia : conclu�a
concluira : conclu�ra
conclu�rmos : concluirmos
conclu�u : concluiu
condizessem : condissessem
cond�-la : condu-la
condus : conduz
condusir : conduzir
conecs�o : conex�o
conexionados : conexos
c�ngegue : c�njuge
c�njuga : c�njuge
c�njugue : c�njuge
conscencioso : consciencioso
consciencia : consci�ncia
consegui-se : conseguisse
conserne : concerne
consernir : concernir
consider : considere
consinteis : consintais
consomas : consumas
consomir : consumir
consporcar : conspurcar
Constacto : Constato
constitue : constitui
constituia : constitu�a
constitu�ndo : constituindo
constituira : constitu�ra
constituitivo : constitutivo
constroiem : constroem
construi : constru�
construia : constru�a
cont�em : cont�m
contens : cont�ns
conti-me : contive-me
contra-prova : contraprova
contracto : contrato
contractos : contratos
contrai-lo : contra�-lo
contraiem : contraem
contrassenso : contra-senso
contribu�nte : contribuinte
contribuitivo : contributivo
contric��o : contri��o
control : controlo
contr�le : controlo
convem : conv�m
convens : conv�ns
convir : convier
c�r : cor
c�r : cor
corajem : coragem
cordeal : cordial
c�res : cores
c�res : cores
coroneis : coron�is
corr�colo : curr�culo
corr�culo : curr�culo
corropio : corrupio
cortezia : cortesia
coscovilheiras : coscuvilheiras
coscovilhice : coscuvilhice
cr�neo : cr�nio
crea��o : cria��o
creador : criador
crear : criar
creatura : criatura
creem : cr�em
cr�m : cr�em
creoulo : crioulo
cristamente : crist�mente
cristanmente : crist�mente
crusador : cruzador
crusar : cruzar
cruseiro : cruzeiro
cubi�a : cobi�a
cubi�ar : cobi�ar
culidir : colidir
culigir : coligir
culina : colina
culis�o : colis�o
culiseu : coliseu
curr�colo : curr�culo
curropio : corrupio
custume : costume
da-me : d�-me
damos-nos : damo-nos
dansar : dan�ar
darnos : dar-nos
decaiem : decaem
defenido : definido
defeza : defesa
degec��o : dejec��o
degejuar : desjejuar
degejum : desjejum
degladiar : digladiar
deix�sse-mos : deix�ssemos
deje��o : dejec��o
dejetos : dejectos
deleciosas : deliciosas
delegenciar : diligenciar
deligencia : dilig�ncia
d�m : d�em
deminuto : diminuto
d�mos : demos
dep�r : depor
depos : dep�s
depoz : dep�s
depremido : deprimido
depremir : deprimir
derruido : derru�do
desa�ocego : desassossego
desac�rdo : desacordo
desassocego : desassossego
desassossiar : desassociar
descan�ar : descansar
descan�o : descanso
descelar : desselar
descontra��o : descontrac��o
descubri : descobri
desenchabido : desenxabido
desenteria : disenteria
desfasajem : desfasagem
desfazagem : desfasagem
desfazer-te-ia : desfar-te-ia
desfeicho : desfecho
desf�s : desfez
deshabitar : desabitar
desharmonia : desarmonia
deshonestidade : desonestidade
deshonesto : desonesto
deshonra : desonra
desiquel�brio : desequil�brio
desiquil�brio : desequil�brio
deslisar : deslizar
deslise : deslize
desmoralisar : desmoralizar
desoito : dezoito
despachanta : despachante
desped�-la : despedi-la
desp�ndio : disp�ndio
despendioso : dispendioso
despeza : despesa
despr�zo : desprezo
despr�zo : desprezo
desseminado : disseminado
desseminar : disseminar
desser : descer
dessimula��o : dissimula��o
dessimulado : dissimulado
dessimular : dissimular
destinta : distinta
destroi : destr�i
destruido : destru�do
deteu : deteve
dexer : descer
dezacordo : desacordo
deza�ossiar : desassociar
dezalinho : desalinho
dezentendimento : desentendimento
dezespero : desespero
dez�ito : dezoito
d�-lo : di-lo
di��o : dic��o
diccion�rio : dicion�rio
dignat�rio : dignit�rio
dignit�reo : dignit�rio
dijerir : digerir
dijest�o : digest�o
dijiro : digiro
diminuiram : diminu�ram
diminuitivo : diminutivo
dinossaurios : dinoss�urios
di�nisicas : dionis�acas
dirijisse : dirigisse
dis : diz
discre��o : discri��o
discu��es : discuss�es
diser : dizer
disfruta-se : desfruta-se
disfrutado : desfrutado
disfrutador : desfrutador
disfrutar : desfrutar
disfrute : desfrute
dispar : d�spar
dispendedor : despendedor
dispender : despender
dispendido : despendido
disposer : dispuser
dissere : disser
dissereis : diss�reis
dissuador : dissuasor
dissuazivo : dissuasivo
dissuazor : dissuasor
disten��o : distens�o
distrai-lo : distra�-lo
distraiem : distraem
distra�r : distrair
distribui-lo : distribu�-lo
districto : distrito
div�rgencia : diverg�ncia
dizer-se-� : dir-se-�
dizer-se-�o : dir-se-�o
dizer-te-ia : dir-te-ia
d�o : doo
eboliente : ebuliente
efabola��o : efabula��o
efabolar : efabular
�febo : efebo
efeveresc�ncia : efervesc�ncia
efeversc�ncia : efervesc�ncia
egoismo : ego�smo
egurgitar : ingurgitar
egurjitar : ingurgitar
eide : hei-de
electro-encefalograma : electroencefalograma
elejer : eleger
eletrotecnica : electrot�cnica
�lite : elite
el�tico : el�ptico
elocidar : elucidar
embaixadora : embaixatriz
embevedar : embebedar
embevedava : embebedava
embriagu�s : embriaguez
embucadura : embocadura
embulado : embolado
embular : embolar
embuscada : emboscada
emi��o : emiss�o
emi�ora : emissora
emita��o : imita��o
emitar : imitar
emmagrecer : emagrecer
emmoldurar : emoldurar
empreza : empresa
encaiches : encaixos
encaxes : encaixes
encertar : encetar
enchada : enxada
enchado : inchado
enchar : inchar
enchovalhada : enxovalhada
enchovalhar : enxovalhar
enchugar : enxugar
enchuto : enxuto
enc�modo : inc�modo
encomudo : inc�modo
encorage : encoraje
enesqueciveis : inesquec�veis
enesquecivel : inesquec�vel
�nfa-se : �nfase
engorjitar : engorgitar
engrachador : engraxador
engrachar : engraxar
engurgitar : engorgitar
enluada : aluada
enovador : inovador
ent�o : entoo
entr�va-mos : entr�vamos
entreteste-te : entretiveste-te
entreteu-se : entreteve-se
entreti-me : entretive-me
entretiam : entretinham
entumescer : intumescer
entumescia : intumescia
entupes : entopes
enviezado : enviesado
enxagoar : enxaguar
equisema : eczema
erban�rio : ervan�rio
erban�rio : herban�rio
ereis : �reis
eremita : ermita
erimita : ermita
eritrocitos : eritr�citos
erodito : erudito
erpes : herpes
�rro : erro
�rro : erro
er�dito : erudito
esb��o : esbo�o
esb��o : esbo�o
esclamar : exclamar
esclamou : exclamou
esclusivo : exclusivo
esdr�xola : esdr�xula
esfero-gr�fica : esferogr�fica
esforsam : esfor�am
esgaseado : esgazeado
es�mio : ex�mio
esmaltear : esmaltar
espaguete : esparguete
especime : esp�cime
especimens : esp�cimes
espectativas : expectativas
espertesa : esperteza
esp�sso : espesso
espetativa : expectativa
espicassar : espica�ar
espontaniedade : espontaneidade
espont�nio : espont�neo
espont�nio : espont�neo
esp�sa : esposa
esp�so : esposo
espurgar : expurgar
esquesitisse : esquisitice
esquesito : esquisito
establecer : estabelecer
estenuante : extenuante
estepor : estupor
esteporado : estuporado
estipid�s : estupidez
est�mago : est�mago
estors�o : extors�o
est�rvo : estorvo
est�rvo : estorvo
estranhesa : estranheza
estranjeirismo : estrangeirismo
estranjeiro : estrangeiro
estratejista : estrategista
estravag�ncias : extravag�ncias
estravasar : extravasar
estraviar : extraviar
estreitesa : estreiteza
estrelato : estrelado
estr�pido : estr�pito
estrovar : estorvar
estructurado : estruturado
estupurado : estuporado
esvasiar : esvaziar
et�rio : et�reo
eutan�zia : eutan�sia
evitae : evitai
exceps�o : excep��o
exceto : excepto
exdr�xula : esdr�xula
exdr�xulas : esdr�xulas
eximio : ex�mio
exitar : hesitar
exito : hesito
expecialmente : especialmente
expesso : espesso
expl�ndido : espl�ndido
explendor : esplendor
expont�neo : espont�neo
Extender : Estender
extendidos : estendidas
extor��o : extors�o
extravazar : extravasar
fabolar : fabular
faboloso : fabuloso
fac-simile : fac-s�mile
fachina : faxina
faisca : fa�sca
fa�scar : faiscar
falariam-nos : falar-nos-iam
fal�steis : falastes
far�a : farsa
far�a-mos : far�amos
farramenta : ferramenta
faser : fazer
faz�-lo-ias : f�-lo-ias
fazer-se-� : far-se-�
fazer-se-�o : far-se-�o
femenilidade : feminilidade
f�mur : f�mur
femural : femoral
ferr�gem : ferrugem
ferrujem : ferrugem
fertilisar : fertilizar
f�-lo : fi-lo
fiabelidade : fiabilidade
fiablidade : fiabilidade
finaflor : fina-flor
fiqueim : fiquem
fiscalisa��o : fiscaliza��o
fiscalisar : fiscalizar
f�sicos-qu�micos : f�sico-qu�micos
fisilogia : fisiologia
fiz-lo : fi-lo
fizes-te : fizeste
flu�dez : fluidez
fl�idez : fluidez
fluidico : flu�dico
flu�do : fluido
fogu�te : foguete
f�r : for
f�ra : fora
f�r�a : for�a
f�rem : forem
formusura : formosura
f�ro : foro
fortivo : furtivo
forum : f�rum
foruns : f�runs
fosforecente : fosforescente
fransido : franzido
fransir : franzir
fraquesa : fraqueza
frenezi : frenesi
frenezim : frenesim
freza : fresa
frezadora : fresadora
friza : frisa
frizar : frisar
frizo : friso
frustat�rio : frustrat�rio
fugire : fugir
furmosura : formosura
furmusura : formosura
furtuito : fortuito
furtunas : fortunas
gabardine : gabardina
galin�cio : galin�ceo
gasela : gazela
gasua : gazua
gazeado : gaseado
geito : jeito
geitosa : jeitosa
g�rme : germe
germen : g�rmen
gerundio : ger�ndio
giboia : jib�ia
gib�ia : jib�ia
gib�ia : jib�ia
gimn�sio : gin�sio
giradiscos : gira-discos
gis : giz
gordoroso : gorduroso
gorgeta : gorjeta
goso : gozo
g�zo : gozo
gracil : gr�cil
gra�nha : grainha
grangear : granjear
gratu�to : gratuito
gravid�s : gravidez
gravideses : gravidezes
GRECIA : GR�CIA
gromete : grumete
grum�te : grumete
gurdoroso : gorduroso
habitoo-se : habituou-se
hainda : ainda
helimotor : heliomotor
helioporto : heliporto
hemorregia : hemorragia
heriditariedade : hereditariedade
hervan�rio : ervan�rio
hervan�rio : herban�rio
heterog�neo : heterog�neo
heterog�nias : heterog�neas
heterog�nio : heterog�neo
hexitar : hesitar
h�xito : �xito
hidrog�neo : hidrog�nio
hidrog�nio : hidrog�nio
hieroglifos : hier�glifos
higi�ne : higiene
hijiene : higiene
hilariedade : hilaridade
hiper-sensibilidade : hipersensibilidade
hipnotisa��o : hipnotiza��o
hipnotisado : hipnotizado
hipnotisador : hipnotizador
hipnotisar : hipnotizar
hipnoze : hipnose
hipodromo : hip�dromo
hiredit�rio : heredit�rio
holand�ses : holandeses
homo-sexualidade : homossexualidade
homog�neo : homog�neo
homog�nio : homog�neo
homogenizar : homogeneizar
horisonte : horizonte
h�stil : hostil
hovesse : houvesse
�am : iam
iamos : �amos
�as : ias
�bero : ibero
idealogia : ideologia
idenpotente : idempotente
identica : id�ntica
idoniedade : idoneidade
ieis : �eis
igiene : higiene
ilhoses : ilh�s
ilucidar : elucidar
imcompleto : incompleto
imiss�o : emiss�o
imperadora : imperatriz
impertigado : empertigado
imploz�o : implos�o
implus�o : implos�o
impolsionar : impulsionar
imp�dico : impudico
impulsiunar : impulsionar
imundice : imund�cie
inabeis : in�beis
in�udito : inaudito
incer��o : inser��o
incerir : inserir
incluia : inclu�a
incluiam : inclu�am
incluido : inclu�do
inclu�ndo : incluindo
incluiram : inclu�ram
inclu�r�o : incluir�o
inclu�rdes : incluirdes
incluir�a : incluiria
inclu�ria : incluiria
inclu�rmos : incluirmos
incluisse : inclu�sse
inclu�u : incluiu
inclusiv� : inclusive
inconpleto : incompleto
incorajar : encorajar
incrostar : incrustar
incrostrada : incrustada
indiv�dua : indiv�duo
infraestrutura : infra-estrutura
Infraestrutura : Infra-estrutura
infraestruturas : infra-estruturas
ingec��es : injec��es
ingl�ses : ingleses
inglezice : inglesice
inglezisse : inglesice
inh�bil : in�bil
�nicio : in�cio
inje��o : injec��o
insers�o : inser��o
insistencia : insist�ncia
inssondaveis : insond�veis
inssurrei��o : insurrei��o
insurreiss�o : insurrei��o
inter-comunicador : intercomunicador
inter-institucionais : interinstitucionais
inter-sexual : intersexual
inter-sexualidade : intersexualidade
inter�sses : interesses
intergei��o : interjei��o
interrop��o : interrup��o
intersecsual : intersexual
intervia : intervinha
intervido : intervindo
intervisse : interviesse
interviu : interveio
intransij�ncia : intransig�ncia
intransijente : intransigente
intranzijente : intransigente
intrepor : interpor
intrevido : intervindo
intrevisto : entrevisto
intuia : intu�a
inxugar : enxugar
inxuto : enxuto
ir-mos : irmos
irrasc�vel : irasc�vel
items : itens
itener�rio : itiner�rio
jiboia : jib�ia
joia : j�ia
j�vem : jovem
j�vens : jovens
joventude : juventude
ju�so : ju�zo
juizes : ju�zes
juizo : ju�zo
junho : Junho
j�niores : juniores
juri : j�ri
Kg : kg
kilo : quilo
kil�metro : quil�metro
Km : km
ladiar : ladear
lage : laje
lagem : lajem
lambusado : lambuzado
lampe�o : lampi�o
lapis : l�pis
largato : lagarto
Latinoamericano : Latino-americano
l�-la : l�-la
les�ria : lez�ria
letivo : lectivo
leucocitos : leuc�citos
levesa : leveza
li�en�as : licen�as
licensas : licen�as
licensiado : licenciado
liche : lixe
ligeiresa : ligeireza
lijeireza : ligeireza
lijeiro : ligeiro
limpesa : limpeza
lingu�sta : linguista
linguistica : lingu�stica
linxado : linchado
l�gicamente : logicamente
logotipo : log�tipo
logutipo : log�tipo
l�mbago : lumbago
lunbago : lumbago
l�polo : l�pulo
lusitaneidade : lusitanidade
lusitaniedade : lusitanidade
ma�agista : massagista
macissos : maci�os
madre-silva : madressilva
magestoso : majestoso
magresa : magreza
m�gua : m�goa
mal-casado : malcasado
mal-cheiroso : malcheiroso
mal-contente : malcontente
mal-criado : malcriado
mal-feito : malfeito
mal-me-quer : malmequer
mal-nascido : malnascido
mal-visto : malvisto
malavisado : mal-avisado
malencarado : mal-encarado
malentendidos : mal-entendidos
malidic�ncias : maledic�ncias
mamarraxo : mamarracho
mangan�s : mangan�s
mangerico : manjerico
mantem-se : mant�m-se
manti-me : mantive-me
Mariza : Marisa
marm�rico : marm�reo
marm�rio : marm�reo
martirisar : martirizar
matris : matriz
mausoleu : mausol�u
mecher : mexer
mecher-lhe : mexer-lhe
m�dica-cir�rgica : m�dico-cir�rgica
m�dicos-cir�rgicos : m�dico-cir�rgicos
mediocre : med�ocre
medium : m�dium
mediuns : m�diuns
memorandu : memorando
menistro : ministro
mens�o : men��o
mensionar : mencionar
mercieiro : merceeiro
meret�ssimo : merit�ssimo
meseric�rdia : miseric�rdia
m�ta : meta
m�ta : meta
meteriologia : meteorologia
m�tro : metro
microinform�tica : micro-inform�tica
min�mo : m�nimo
minissaia : mini-saia
miradoro : miradouro
miuda : mi�da
miudo : mi�do
mixto : misto
moiem : moem
mo�nho : moinho
m�lhos : molhos
monoc�rdia : monoc�rdica
monotunia : monotonia
m�o : moo
mormura : murmura
mormurar : murmurar
mostr�o : mostram
mostreios : mostrei-os
mu� : mo�
mulhado : molhado
multim-media : multim�dia
municioso : minucioso
munotonia : monotonia
muribundo : moribundo
mussulmano : mu�ulmano
mustrar : mostrar
neo-latino : neolatino
neuro-ps�quico : neurops�quico
nitrog�neo : nitrog�nio
nitrog�nio : nitrog�nio
nobresa : nobreza
norueste : noroeste
notabiliza��o : notabilidade
n�vel : novel
nuno : Nuno
n�vem : nuvem
obce��o : obsess�o
obcess�o : obsess�o
obcessivo : obsessivo
obececar : obcecar
obetenho : obtenho
obezidade : obesidade
obj�ctivo : objectivo
Objetos : Objectos
obrigatoriadade : obrigatoriedade
obseca��o : obceca��o
obsecado : obcecado
obse��o : obsess�o
obsecar : obcecar
obsecass�o : obceca��o
obseletos : obsoletos
obsequia : obsequeia
obsuletos : obsoletos
obzequiar : obsequiar
�ca : oca
�co : oco
ocurrer : ocorrer
odia : odeia
odie : odeie
odiem : odeiem
ogemose : osmose
olfativo : olfactivo
oliar : olear
�lio : �leo
omi�o : omisso
onanimista : unanimista
openi�o : opini�o
�pinar : opinar
op�r : opor
organisa��o : organiza��o
organisar : organizar
org�os : �rg�os
or�gem : origem
ostrassismo : ostracismo
�timo : �ptimo
ourina : urina
ourinar : urinar
ourinol : urinol
outubro : Outubro
ouv�-lo : ouvi-lo
oxila��es : oscila��es
r� : p'pr�
paci�nsia : paci�ncia
pagem : pajem
paizagem : paisagem
pandega : p�ndega
p�ndigo : p�ndego
paposseco : papo-seco
para-choques : p�ra-choques
parachoques : p�ra-choques
paraliza��o : paralisa��o
paralizar : paralisar
paraquedas : p�ra-quedas
pararraios : p�ra-raios
parteleira : prateleira
parvoice : parvo�ce
passeo : passeio
passiar : passear
passiei : passeei
passiemos : passeemos
passi�ncia : paci�ncia
p�teo : p�tio
patrim�nio : patrim�nio
pchisbeque : pechisbeque
p�cego : p�ssego
p�che : peixe
peco�ria : pecu�ria
ped�-la-ei : pedi-la-ei
p�ga : pega
p�ga : pega
p�gada : pegada
peiche : peixe
penalisante : penalizante
pendoricalho : penduricalho
penduresa : pendureza
penecilina : penicilina
penincilina : penicilina
pequen�s : pequenez
pera : p�ra
p�ras : peras
perceisamente : precisamente
perceito : preceito
perceptorado : preceptorado
perclaro : preclaro
perconizar : preconizar
percu�ria : pecu�ria
p�rda : perda
perdominar : predominar
perduar : perdoar
perduou : perdoou
perferivel : prefer�vel
periodo : per�odo
perju�zo : preju�zo
permissa : premissa
perp�cio : prep�cio
persagiam : pressagiam
persentido : pressentido
perspetiva : perspectiva
persta��es : presta��es
persuaz�o : persuas�o
pertens�o : pretens�o
perver��o : pervers�o
pesarozo : pesaroso
pesc��o : pesco�o
p�so : peso
pesso : pe�o
petisa : petiza
petr�lio : petr�leo
p�xe : peixe
pezadelo : pesadelo
pezar : pesar
pezaroso : pesaroso
pictoresco : pinturesco
pil�to : piloto
pil�tos : pilotos
pintoresco : pinturesco
pique-nique : piquenique
piquena : pequena
pirezinho : piresinho
piroupo : piropo
pituresco : pitoresco
piugada : peugada
plat�ia : plateia
pleiade : pl�iade
po-lo : p�-lo
pobresa : pobreza
pobresinho : pobrezinho
poco : pouco
p�co : pouco
podera : pudera
poderam : puderam
poderia-me : poder-me-ia
podessemos : pud�ssemos
poem : p�em
p�em : p�em
po�ticos-liter�rios : po�tico-liter�rios
polas : pulas
polig�mia : poligamia
politecnico : polit�cnico
ponteagudo : pontiagudo
porlongar : prolongar
porlongue : prolongue
portec��o : protec��o
portugues : portugu�s
portugu�sa : portuguesa
portugu�smente : portuguesmente
porvid�ncia : provid�ncia
pos : p�s
poseres : puseres
posescolar : p�s-escolar
posesses : pusesses
posglaci�rio : p�s-glaci�rio
posoperat�rio : p�s-operat�rio
possiblidade : possibilidade
possiveis : poss�veis
possivel : poss�vel
potuguezismo : portuguesismo
p�z-se : p�s-se
pozes : poses
poz�sseis : pus�sseis
poz�ssemos : pus�ssemos
pozinhos : posinhos
pr� : pr�
precal�o : percal�o
preceitoar : preceituar
preceveran�a : perseveran�a
precizar : precisar
preconisar : preconizar
predidos : perdidos
predum�nio : predom�nio
prefazer : perfazer
preju�so : preju�zo
prejuizo : preju�zo
premear : premiar
pr�meo : pr�mio
premiss�o : permiss�o
prenc�pio : princ�pio
prenh�s : prenhez
preplexidade : perplexidade
preplexo : perplexo
prescruta��o : perscruta��o
prescrutador : perscrutador
prespectiva : perspectiva
pressajiar : pressagiar
presserverar : perseverar
presseveran�a : perseveran�a
prestass�es : presta��es
presuas�o : persuas�o
preten��o : pretens�o
pretencioso : pretensioso
pretesto : pretexto
prevers�o : pervers�o
preversidade : perversidade
preverso : perverso
preverter : perverter
previl�gio : privil�gio
prezumido : presumido
prezun��o : presun��o
primasia : primazia
pr�ncepe : pr�ncipe
principe : pr�ncipe
priveligiado : privilegiado
probolemas : problemas
procheneta : proxeneta
productos : produtos
profundesa : profundeza
progre��o : progress�o
projeto : projecto
projetos : projectos
promenor : pormenor
promenores : pormenores
propraga��o : propaga��o
propridade : propriedade
proroga��o : prorroga��o
prorogado : prorrogado
prorogar : prorrogar
prorrugar : prorrogar
prossessador : processador
protextar : protestar
protexto : protesto
prototipo : prot�tipo
provalvelmente : provavelmente
proventura : porventura
prov�ssemos : prov�ssemos
providenci�-lo : providenci�-lo
PROVINIENTE : PROVENIENTE
provinientes : provenientes
pruibido : proibido
psico-social : psicossocial
psico-som�tico : psicossom�tico
p�-lo : pu-lo
p�-la : pu-la
puder� : poder�
pulido : polido
pulimos : polimos
pulmunar : pulmonar
puresa : pureza
puz : pus
puzemos : pusemos
puzera : pusera
puzeram : puseram
puzeras : puseras
puzeres : puseres
puzermos : pusermos
puzesse : pusesse
puzesses : pusesses
puzeste : puseste
pxisbeque : pechisbeque
quartas-feiras : Quartas-feiras
queiremos : queiramos
quer-o : quere-o
quere : quer
quere-me : quer-me
quere-se : quer-se
quer�mo-lo : queremo-lo
qu�-lo : qui-lo
qui�a : qui��
qu�s : quis
quis-lo : qui-lo
quisere : quiser
quis�steis : quisestes
quiss� : qui��
quiz : quis
quizemos : quisemos
quizer : quiser
quizera : quisera
quizeram : quiseram
quiz�ramos : quis�ramos
quizeras : quiseras
quizerdes : quiserdes
quizerem : quiserem
quizeres : quiseres
quizesse : quisesse
quizessem : quisessem
quizeste : quiseste
quiz�steis : quisestes
rabuge : rabuje
rabujento : rabugento
rabujice : rabugice
rabuscada : rebuscada
r�dio-amador : radioamador
ra�nha : rainha
ra�z : raiz
rangir : ranger
rapasinho : rapazinho
r�pidamente : rapidamente
rasia : razia
raza : rasa
razo : raso
reajir : reagir
recaiem : recaem
recentimento : ressentimento
recentir : ressentir
recepiente : recipiente
rectroactivas : retroactivas
rectroactivo : retroactivo
rectroactivos : retroactivos
redatorial : redactorial
redijir : redigir
redol : Redol
reeinstalar : reinstalar
refelex�o : reflex�o
refer-se : refere-se
referirnos-emos : referir-nos-emos
refletir : reflectir
regei��o : rejei��o
regeitar : rejeitar
r�go : rego
regorgitar : regurgitar
reincarnar : reencarnar
reinvidica��es : reivindica��es
reinvidicar : reivindicar
rejeiss�o : rejei��o
rejisto : registo
rejovenescer : rejuvenescer
rejovenescimento : rejuvenescimento
relac��o : rela��o
relaccionados : relacionados
remedia : remedeia
remedio : remedeio
repucho : repuxo
repurt�rio : repert�rio
requere : requer
requere-se : requer-se
requesitos : requisitos
resgistados : registados
resplandesc�ncia : resplandec�ncia
resplandescente : resplandecente
ressaiem : ressaem
ressurjir : ressurgir
ressurreiss�o : ressurrei��o
r�stea : r�stia
restricto : restrito
restrinjir : restringir
reteu : reteve
reto : recto
reunes : re�nes
re�nir : reunir
reuno : re�no
rezina : resina
riagir : reagir
rid�colo : rid�culo
ringi : rangi
ringido : rangido
riquesa : riqueza
rob�ula : rub�ola
rolissa : roli�a
rolisso : roli�o
roptura : ruptura
rouxinois : rouxin�is
roxinol : rouxinol
r�brica : rubrica
ru� : ro�
ruido : ru�do
ruimente : ruimmente
sacrilegadamente : acrilegamente
saida : a�da
saiem : aem
saimos : a�mos
sa�ndo : aindo
sa�r : air
saira : a�ra
sa�r� : air�
sairam : a�ram
sa�r�o : air�o
sa�r�s : air�s
sa�rdes : airdes
sairem : a�rem
sa�remos : airemos
saires : a�res
sa�rmos : airmos
sa�u : aiu
salganhada : algalhada
saliba : aliva
salvaguadar : alvaguardar
saracotiar : aracotear
s�udade : audade
saude : a�de
sear : cear
secrestar : equestrar
secresto : equestro
secretar�a : ecretaria
segnificado : ignificado
seia : ceia
Sele��o : Selec��o
selecionar : eleccionar
selinidade : enilidade
selvajamente : elvaticamente
selvajem : elvagem
selvajeria : elvageria
semi-anual : emianual
semi-cerrado : emicerrado
semi-circular : emicircular
semi-eixo : emieixo
semi-oficioso : emioficioso
semi-vogal : emivogal
semihomem : emi-homem
semiinconsciente : emi-inconsciente
semirrei : emi-rei
semiss�bio : emi-s�bio
semisselvagem : emi-selvagem
sen�ura : censura
sensura : censura
sensuras : censuras
sera : cera
s�ra : cera
seram : er�o
sereal : cereal
ser�am : eriam
serimonioso : cerimonioso
serzir : cerzir
setim : cetim
setor : ector
setores : ectores
Sexta-Feira : Sexta-feira
sextas-feiras : Sextas-feiras
sifl�tico : ifil�tico
simbolo : �mbolo
sinosite : inusite
sintasse : intaxe
sint�tico : int�ctico
sintonisar : intonizar
sinuzite : inusite
s�be : oube
sobrecelente : obresselente
sobrehumano : obre-humano
sobridade : obriedade
socegado : ossegado
socegar : ossegar
socego : ossego
sociadade : ociedade
so�ubrar : o�obrar
socumbir : ucumbir
sodeste : udeste
sodueste : udoeste
s�mente : omente
son�mbolo : on�mbulo
sorjo : urjo
sorrizinho : orrisinho
sorv�te : orvete
sosinho : ozinho
sossobrar : o�obrar
sot�os : �t�os
sovieticos : ovi�ticos
s�zinho : ozinho
sub-delegado : ubdelegado
sub-grupo : ubgrupo
Sub-grupo : Subgrupo
sub-solos : ubsolos
subesservi�ncia : ubservi�ncia
subibliotec�rio : ub-bibliotec�rio
subito : �bito
subrepticiamente : ub-repticiamente
subrepticio : ub-rept�cio
substituia : ubstitu�a
substituitivo : ubstitutivo
substitu�u : ubstituiu
substracto : ubstrato
su�obrar : o�obrar
sujerir : ugerir
sujest�o : ugest�o
sunambulismo : onambulismo
s�per-homem : uper-homem
superhomem : uper-homem
suprassumo : upra-sumo
supre��o : upress�o
supresti��o : upersti��o
supresticioso : upersticioso
surjir : urgir
surpr�sa : urpresa
surpreza : urpresa
surrapa : zurrapa
survete : orvete
suspen��o : uspens�o
susseder : uceder
taboleiro : tabuleiro
talv�s : talvez
tambem : tamb�m
tartante : tratante
t�tica : t�ctica
t�tico : t�ctico
teem : t�m
tele-guiado : teleguiado
televizivo : televisivo
t�m : tem
tem-o : tem-no
t�nue : t�nue
t�nues : t�nues
terebentina : terebintina
terjeitos : trejeitos
terramoto : terremoto
terraplanagem : terraplenagem
terraplanar : terraplenar
terraqueo : terr�queo
terr�quio : terr�queo
t�steis : t�xteis
tetos : tectos
teurap�utico : terap�utico
texteis : t�xteis
t�xteis : t�xteis
tijela : tigela
tor�xico : tor�cico
torc�colo : torcicolo
tors�o : tor��o
torser : torcer
torsida : torcida
torsido : torcido
t�rso : torso
tot�m : totem
totens : t�temes
toxico : t�xico
tragect�ria : traject�ria
traiem : traem
traj�dia : trag�dia
trajeto : trajecto
trajet�ria : traject�ria
tr�jico : tr�gico
tranquilisador : tranquilizador
tranquilisante : tranquilizante
tr�nsido : transido
transmetir : transmitir
transmi��o : transmiss�o
transmitente : transmissor
tranze : transe
tranzido : transido
traser : trazer
traz�-lo-ei : tr�-lo-ei
traz�-lo-ia : tr�-lo-ia
trazeira : traseira
trazeiro : traseiro
trazer-nos-ia : trar-nos-ia
trazer-se-� : trar-se-�
trazer-se-�o : trar-se-�o
tregeitos : trejeitos
tres : tr�s
trez : tr�s
tri-campe�o : tricampe�o
tricampi� : tricampe�
trilingue : tril�ngue
tristesa : tristeza
tr�co : troco
trousse : trouxe
troussestes : trouxestes
tunel : t�nel
turc�colo : torcicolo
ultra-violeta : ultravioleta
�mido : h�mido
un�ssuno : un�ssono
urano : ur�nio
utilisar : utilizar
utlizadores : utilizadores
v�cum : vacum
vag�os : vag�es
vasio : vazio
v� : v�
veiculo : ve�culo
veinculado : veiculado
v�m : vem
v�rbo : verbo
v�rbo : verbo
veredito : veredicto
veria��o : verea��o
veriador : vereador
vert�gem : vertigem
vert�gens : vertigens
veses : vezes
veu : v�u
vi�steis : viestes
vintem : vint�m
v�rgem : virgem
visinhan�a : vizinhan�a
visinho : vizinho
viuva : vi�va
viuv�s : viuvez
vi�vez : viuvez
viuvo : vi�vo
viva�o : vivaz
vivasso : vivaz
viz�o : vis�o
vizar : visar
vizita : visita
vizitante : visitante
viz�vel : vis�vel
vizualisar : visualizar
vizualizar : visualizar
vocemess� : vossemec�
vo� : voou
v�o : voo
voses : vozes
vossemess� : vossemec�
vozeria : vozearia
vu� : voou
vuou : voou
xadresista : xadrezista
xal : xale
xalupa : chalupa
x�vena : ch�vena
x�x� : xex�
xixi : chichi
xucha : chucha
xuxa : chucha
zenite : z�nite
zig-zag : ziguezague
� : �
�rvore : �rvore
acessas : acesas
actividadees : actividades
Administar��o : Administra��o
Agosot : Agosto
alg�m : algu�m
algorimto : algoritmo
amplamante : amplamente
aolgoritmos : algoritmos
aproxiam��o : aproxima��o
arrajemos : arranjemos
avivizinham : avizinham
Barsil : Brasil
Bibliteca : Biblioteca
Bilioteca : Biblioteca
bolachinas : bolachinhas
brincadira : brincadeira
Camarados : Camaradas
candiadatos : candidatos
candiadaturas : candidaturas
candiadturas : candidaturas
caracteriscas : caracter�sticas
cedererem : cederem
Chesfes : Chefes
cinetificas : cient�ficas
cobe : coube
comec� : come�a
computadres : computadores
comtempla : contempla
conguir : conseguir
constitudo : constitu�do
Contacos : Contactos
contrbuir : contribuir
contrpartida : contrapartida
contunar : continuar
contunar : continuar
correpondencia : correspond�ncia
corres-pond�ncia : correspond�ncia
correspondecia : correspond�ncia
correspondenccia : correspond�ncia
cultuarais : culturais
demaais : demais
demonstar��es : demonstra��es
desenvimento : desenvolvimento
desenvovimento : desenvolvimento
desulpem : desculpem
dificukdades : dificuldades
diger : dizer
Direcc��o : Direc��o
discus�o : discuss�o
disses : disse
divlugue : divulgue
divugar : divulgar
domnos : donos
doutirado : doutorado
dsenvolvimento : desenvolvimento
eatarem : estarem
econtra : encontra
ecosistemas : ecossistemas
eferendo : referendo
Efificio : Edif�cio
elega��o : delega��o
emnos : menos
enconbtra : encontra
ENCONTA-SE : ENCONTRA-SE
ENCONTAM-SE : ENCONTRAM-SE
encontar : encontrar
Epediente : Expediente
escever : escrever
espirrito : esp�rito
esssa : essa
establecer : estabelecer
estajam : estejam
estass : estas
exeplares : exemplares
exist�mcia : exist�ncia
exitencia : exist�ncia
experiancia : experi�ncia
Extrordinaria : Extraordin�ria
favor�aveis : favor�veis
fazere : fazer
fiabiliade : fiabilidade
fianciamento : financiamento
fidalgias : fidalguias
flutuaa��es : flutua��es
fomato : formato
frustados : frustrados
gabinte : gabinete
garatir : garantir
graande : grande
Homesns : Homens
idea : ideia
ideiua : ideia
imeditamente : imediatamente
implemenetam : implementam
impossival : imposs�vel
imputads : imputados
inauguardo : inaugurado
inciar : iniciar
inciativas : iniciativas
incrito : inscrito
Indistrial : Industrial
indiviseis : indivis�veis
indivuduais : individuais
infoma��es : informa��es
inforam��o : informa��o
informmatica : inform�tica
inscever-se : inscrever-se
instituo��o : institui��o
institutoas : institutos
interesado : interessado
interesados : interessados
interesante : interessante
interssado : interessado
Intitui��es : Institui��es
investig��o : investiga��o
iscuss�o : discuss�o
isoladamnete : isoladamente
itesm : itens
la�amento : lan�amento
leventado : levantado
liagassem : ligassem
libera��o : liberta��o
licancas : licen�as
licenciatua : licenciatura
LUMIMOSA : LUMINOSA
malata : malta
mandase : mandasse
mandassess : mandasses
mebros : membros
memso : mesmo
mewses : meses
momemto : momento
Multmedia : Multim�dia
mundan�a : mudan�a
muuito : muito
n�o : n�o
naao : n�o
nais : mais
natale : natal
necesitar : necessitar
necess�io : necess�rio
nemhuma : nenhuma
nomeadamentem : nomeadamente
nomeadamento : nomeadamente
nomedamente : nomeadamente
numca : nunca
nuneros : n�meros
oferecen : oferecem
optimisitico : optim�stico
organigrams : organigramas
orginador : originador
ortigr�fica : ortogr�fica
ortigr�fico : ortogr�fico
ourtra : outra
panhado : apanhado
part�pio : partic�pio
partica : pratica
partilihar : partilhar
pekla : pela
perceisamente : precisamente
perguntaou : perguntou
persectivas : perspectivas
pesssoa : pessoa
pesssoal : pessoal
podera : poder�
podiamo : pod�amos
podria : poderia
porgrama : programa
poss-te : posso-te
posss�vel : poss�vel
possso : posso
postall : postal
pprimeiras : primeiras
prblemas : problemas
preceso : preciso
previsvel : previs�vel
princio : princ�pio
probelma : problema
procedimeto : procedimento
processamneto : processamento
produtivade : produtividade
profisssional : profissional
prograssos : progressos
prolemas : problemas
proposcoes : propor��es
publica�a�es : publica��es
Qando : Quando
qaulidade : qualidade
quarquer : qualquer
qui : aqui
qunto : quanto
qye : que
recional : racional
recuros : recursos
relacinado : relacionado
relaizar : realizar
repetui-se : repetiu-se
repons�veis : respons�veis
reponsavel : respons�vel
respectvos : respectivos
responsabnilidade : responsabilidade
sacricios : acrif�cios
Segeum-se : Seguem-se
segir : eguir
seguines : eguintes
selaec��o : elec��o
senytido : entido
serai : erei
Sevi�o : Servi�o
sevi�os : ervi�os
sguerras : guerras
Sgundo : Segundo
sintactica : int�ctica
situ��o : itua��o
sugest�oes : ugest�es
ta�cas : ta�as
tadu��es : tradu��es
tecnogia : tecnologia
telvez : talvez
temnho : tenho
testest : testes
tiveese : tivesse
tranporte : transporte
trentem : tentem
�ultima : �ltima
uiniversitarios : universit�rios
Unversidadese : Universidades
uperiores : uperiores
Utilizdores : Utilizadores
van�ar : avan�ar
verique : verifique
vers�o : vers�o
vers�O : vers�O
vwerificar : verificar
wais : vais
experiancia : experi�ncia
� : �
ab�boda : ab�bada
absti-me : abstive-me
abstrato : abstracto
ace�o : acesso
acelarar : acelerar
�cerca : acerca
acer��o : asser��o
acessabilidade : acessibilidade
aceza : acesa
acezo : aceso
acord�os : ac�rd�os
a�oreano : a�oriano
a�ossiar : associar
actris : actriz
adamastor : Adamastor
adeuzinho : adeusinho
Adotamos : Adoptamos
adotar : adoptar
adquir�-los : adquiri-los
a�rio : a�reo
aero-clube : aeroclube
ageitar : ajeitar
agonisar : agonizar
agradaveis : agrad�veis
ajuisar : ajuizar
album : �lbum
albuns : �lbuns
alerjia : alergia
alfasema : alfazema
alforje : alforge
algasarra : algazarra
alger�s : algeroz
algoses : algozes
alissiante : aliciante
alissiar : aliciar
alizar : alisar
alumeia : alumia
�manh� : amanh�
�mbigua : amb�gua
�mbiguidade : ambiguidade
amenisar : amenizar
analizador : analisador
analizar : analisar
an�lize : an�lise
�ncia : �nsia
ansestral : ancestral
ansestralidade : ancestralidade
ansiolitico : ansiol�tico
ansiul�tico : ansiol�tico
antig�idade : antiguidade
aporado : apurado
aporar : apurar
aporteguesamento : aportuguesamento
aporteguesar : aportuguesar
aquem : aqu�m
�quem : aqu�m
aqu� : aqui
arborisar : arborizar
arid�s : aridez
armazem : armaz�m
armazens : armaz�ns
arquiteto : arquitecto
Arquitetura : Arquitectura
arrange : arranje
arrangei : arranjei
arrangemos : arranjemos
arranges : arranjes
arrazado : arrasado
arrazar : arrasar
arrea : arreia
arregassado : arrega�ado
arregassar : arrega�ar
artf�cio : artif�cio
as�fama : az�fama
ascen��o : ascens�o
aseite : azeite
asenha : azenha
asia : azia
asimute : az�mute
ass�s : assaz
asse�o : acesso
assers�o : asser��o
assesso : acesso
Assessoria : Acessoria
assossiar : associar
ass�car : a��car
assucena : a�ucena
atabalhuar : atabalhoar
atarrachar : atarraxar
aterrorisar : aterrorizar
atl�ctico : atl�tico
atrai��e : atrai�oe
atraissoar : atrai�oar
atraiste : atra�ste
atraves : atrav�s
atravez : atrav�s
atraz : atr�s
atrazar : atrasar
atrazo : atraso
atribuia : atribu�a
atribuiam : atribu�am
atribuiamos : atribu�amos
atribuimos : atribu�mos
atribuiram : atribu�ram
atribu�rei : atribuirei
atribuirem : atribu�rem
atribu�remos : atribuiremos
atribuitivo : atributivo
atriz : actriz
atual : actual
audio-visual : audiovisual
Autoestradas : Auto-estradas
automatisa��o : automatiza��o
autorisar : autorizar
autosuspens�o : auto-suspens�o
autosuspenso : auto-suspenso
autosustenta��o : auto-sustenta��o
averigue : averig�e
avizado : avisado
avizar : avisar
avizo : aviso
az�ago : aziago
azuleijo : azulejo
azuleijos : azulejos
babozeira : baboseira
babuseira : baboseira
bacharlato : bacharelato
bactriana : bacteriana
badagaio : vadagaio
balisa : baliza
banderilha : bandarilha
baptisar : baptizar
baqueteriano : bacteriano
barcassa : barca�a
barr�co : barroco
barr�cos : barrocos
basar : bazar
bas�fia : baz�fia
batizar : baptizar
baze : base
b�be : beb�
b�b� : beb�
belesa : beleza
bemequer : bem-me-quer
Bemfica : Benfica
ben��o : b�n��o
benificia��es : beneficia��es
benificiar : beneficiar
benquerer : bem-querer
benvindo : bem-vindo
berbulha : borbulha
bisarro : bizarro
bisexto : bissexto
bisexual : bissexual
bisexualidade : bissexualidade
bissectris : bissectriz
bissessual : bissexual
bissetriz : bissectriz
bocage : Bocage
boia : b�ia
boiam : b�iam
boie : b�ie
boiem : b�iem
boio : b�io
bolir : bulir
bonus : b�nus
borbolha : borbulha
borbolhar : borbulhar
braza : brasa
brazil : Brasil
bregeiro : brejeiro
briza : brisa
bruxelas : Bruxelas
bujiar : bugiar
burborinho : burburinho
busina : buzina
cafeina : cafe�na
cafeseiro : cafezeiro
caichilho : caixilho
caiem : caem
caimbras : c�ibras
ca�mbras : c�ibras
ca�ndo : caindo
ca�r : cair
ca�r-lhe : cair-lhe
caira : ca�ra
ca�r� : cair�
cairam : ca�ram
ca�r�o : cair�o
ca�r�s : cair�s
ca�rdes : cairdes
cairem : ca�rem
ca�remos : cairemos
caires : ca�res
cairmos : ca�rmos
ca�rmos : cairmos
calc�reo : calc�rio
c�lis : c�lice
calsar : cal�ar
calvice : calv�cie
campa�nha : campainha
campi�o : campe�o
can�ar : cansar
can�aso : cansa�o
can�asso : cansa�o
cans�o : can��o
c�osinho : c�ozinho
c�oz�nho : c�ozinho
cap�s : capaz
captivo : cativo
car�cteres : caracteres
carangueijo : caranguejo
carateres : caracteres
carcassa : carca�a
cardio-vascular : cardiovascular
Carissimos : Car�ssimos
carlos : Carlos
carmos : Carmos
carrocel : carrossel
carroucel : carrossel
cartom�ncia : cartomancia
casc�vel : cascavel
cassarola : ca�arola
catalizar : catalisar
cat�lize : cat�lise
catura : captura
causad�aco : caus�dico
c�ra : cera
c�rca : cerca
c�rca : cerca
cerim�nia : cerim�nia
cerralheiro : erralheiro
cert�me : certame
certesa : certeza
cet�sseo : cet�ceo
ceu : c�u
cezariana : cesariana
chaile : xaile
chale : xale
chapeu : chap�u
chasso : cha�o
chatiar : chatear
chatiava : chateava
chatisse : chatice
chech� : xex�
ch�ch� : xex�
cheinho : cheiinho
che�nho : cheiinho
che�ssimo : chei�ssimo
ch�cara : x�cara
chuxa : chucha
cicatrisar : cicatrizar
cicratisar : cicatrizar
cintaxe : intaxe
ciume : ci�me
claresa : clareza
classismo : classicismo
cobissa : cobi�a
coca-cola : Coca-cola
c�dia : c�dea
colectivisa��o : colectiviza��o
coletiviza��o : colectiviza��o
colijir : coligir
colin�ria : culin�ria
colizeu : coliseu
comb�io : comboio
comperativa : cooperativa
complementariedade : complementaridade
compreen��o : compreens�o
comprendeu : compreendeu
compurscar : conspurcar
comumente : comummente
concenso : consenso
concluia : conclu�a
concluira : conclu�ra
conclu�rmos : concluirmos
conclu�u : concluiu
condizessem : condissessem
cond�-la : condu-la
condus : conduz
condusir : conduzir
conecs�o : conex�o
conexionados : conexos
c�ngegue : c�njuge
c�njuga : c�njuge
c�njugue : c�njuge
conscencioso : consciencioso
consciencia : consci�ncia
consegui-se : conseguisse
conserne : concerne
consernir : concernir
consider : considere
consinteis : consintais
consomas : consumas
consomir : consumir
consporcar : conspurcar
Constacto : Constato
constitue : constitui
constituia : constitu�a
constitu�ndo : constituindo
constituira : constitu�ra
constituitivo : constitutivo
constroiem : constroem
construi : constru�
construia : constru�a
cont�em : cont�m
contens : cont�ns
conti-me : contive-me
contra-prova : contraprova
contracto : contrato
contractos : contratos
contrai-lo : contra�-lo
contraiem : contraem
contrassenso : contra-senso
contribu�nte : contribuinte
contribuitivo : contributivo
contric��o : contri��o
control : controlo
contr�le : controlo
convem : conv�m
convens : conv�ns
convir : convier
c�r : cor
c�r : cor
corajem : coragem
cordeal : cordial
c�res : cores
c�res : cores
coroneis : coron�is
corr�colo : curr�culo
corr�culo : curr�culo
corropio : corrupio
cortezia : cortesia
coscovilheiras : coscuvilheiras
coscovilhice : coscuvilhice
cr�neo : cr�nio
crea��o : cria��o
creador : criador
crear : criar
creatura : criatura
creem : cr�em
cr�m : cr�em
creoulo : crioulo
cristamente : crist�mente
cristanmente : crist�mente
crusador : cruzador
crusar : cruzar
cruseiro : cruzeiro
cubi�a : cobi�a
cubi�ar : cobi�ar
culidir : colidir
culigir : coligir
culina : colina
culis�o : colis�o
culiseu : coliseu
curr�colo : curr�culo
curropio : corrupio
custume : costume
da-me : d�-me
damos-nos : damo-nos
dansar : dan�ar
darnos : dar-nos
decaiem : decaem
defenido : definido
defeza : defesa
degec��o : dejec��o
degejuar : desjejuar
degejum : desjejum
degladiar : digladiar
deix�sse-mos : deix�ssemos
deje��o : dejec��o
dejetos : dejectos
deleciosas : deliciosas
delegenciar : diligenciar
deligencia : dilig�ncia
d�m : d�em
deminuto : diminuto
d�mos : demos
dep�r : depor
depos : dep�s
depoz : dep�s
depremido : deprimido
depremir : deprimir
derruido : derru�do
desa�ocego : desassossego
desac�rdo : desacordo
desassocego : desassossego
desassossiar : desassociar
descan�ar : descansar
descan�o : descanso
descelar : desselar
descontra��o : descontrac��o
descubri : descobri
desenchabido : desenxabido
desenteria : disenteria
desfasajem : desfasagem
desfazagem : desfasagem
desfazer-te-ia : desfar-te-ia
desfeicho : desfecho
desf�s : desfez
deshabitar : desabitar
desharmonia : desarmonia
deshonestidade : desonestidade
deshonesto : desonesto
deshonra : desonra
desiquel�brio : desequil�brio
desiquil�brio : desequil�brio
deslisar : deslizar
deslise : deslize
desmoralisar : desmoralizar
desoito : dezoito
despachanta : despachante
desped�-la : despedi-la
desp�ndio : disp�ndio
despendioso : dispendioso
despeza : despesa
despr�zo : desprezo
despr�zo : desprezo
desseminado : disseminado
desseminar : disseminar
desser : descer
dessimula��o : dissimula��o
dessimulado : dissimulado
dessimular : dissimular
destinta : distinta
destroi : destr�i
destruido : destru�do
deteu : deteve
dexer : descer
dezacordo : desacordo
deza�ossiar : desassociar
dezalinho : desalinho
dezentendimento : desentendimento
dezespero : desespero
dez�ito : dezoito
d�-lo : di-lo
di��o : dic��o
diccion�rio : dicion�rio
dignat�rio : dignit�rio
dignit�reo : dignit�rio
dijerir : digerir
dijest�o : digest�o
dijiro : digiro
diminuiram : diminu�ram
diminuitivo : diminutivo
dinossaurios : dinoss�urios
di�nisicas : dionis�acas
dirijisse : dirigisse
dis : diz
discre��o : discri��o
discu��es : discuss�es
diser : dizer
disfruta-se : desfruta-se
disfrutado : desfrutado
disfrutador : desfrutador
disfrutar : desfrutar
disfrute : desfrute
dispar : d�spar
dispendedor : despendedor
dispender : despender
dispendido : despendido
disposer : dispuser
dissere : disser
dissereis : diss�reis
dissuador : dissuasor
dissuazivo : dissuasivo
dissuazor : dissuasor
disten��o : distens�o
distrai-lo : distra�-lo
distraiem : distraem
distra�r : distrair
distribui-lo : distribu�-lo
districto : distrito
div�rgencia : diverg�ncia
dizer-se-� : dir-se-�
dizer-se-�o : dir-se-�o
dizer-te-ia : dir-te-ia
d�o : doo
eboliente : ebuliente
efabola��o : efabula��o
efabolar : efabular
�febo : efebo
efeveresc�ncia : efervesc�ncia
efeversc�ncia : efervesc�ncia
egoismo : ego�smo
egurgitar : ingurgitar
egurjitar : ingurgitar
eide : hei-de
electro-encefalograma : electroencefalograma
elejer : eleger
eletrotecnica : electrot�cnica
�lite : elite
el�tico : el�ptico
elocidar : elucidar
embaixadora : embaixatriz
embevedar : embebedar
embevedava : embebedava
embriagu�s : embriaguez
embucadura : embocadura
embulado : embolado
embular : embolar
embuscada : emboscada
emi��o : emiss�o
emi�ora : emissora
emita��o : imita��o
emitar : imitar
emmagrecer : emagrecer
emmoldurar : emoldurar
empreza : empresa
encaiches : encaixos
encaxes : encaixes
encertar : encetar
enchada : enxada
enchado : inchado
enchar : inchar
enchovalhada : enxovalhada
enchovalhar : enxovalhar
enchugar : enxugar
enchuto : enxuto
enc�modo : inc�modo
encomudo : inc�modo
encorage : encoraje
enesqueciveis : inesquec�veis
enesquecivel : inesquec�vel
�nfa-se : �nfase
engorjitar : engorgitar
engrachador : engraxador
engrachar : engraxar
engurgitar : engorgitar
enluada : aluada
enovador : inovador
ent�o : entoo
entr�va-mos : entr�vamos
entreteste-te : entretiveste-te
entreteu-se : entreteve-se
entreti-me : entretive-me
entretiam : entretinham
entumescer : intumescer
entumescia : intumescia
entupes : entopes
enviezado : enviesado
enxagoar : enxaguar
equisema : eczema
erban�rio : ervan�rio
erban�rio : herban�rio
ereis : �reis
eremita : ermita
erimita : ermita
eritrocitos : eritr�citos
erodito : erudito
erpes : herpes
�rro : erro
�rro : erro
er�dito : erudito
esb��o : esbo�o
esb��o : esbo�o
esclamar : exclamar
esclamou : exclamou
esclusivo : exclusivo
esdr�xola : esdr�xula
esfero-gr�fica : esferogr�fica
esforsam : esfor�am
esgaseado : esgazeado
es�mio : ex�mio
esmaltear : esmaltar
espaguete : esparguete
especime : esp�cime
especimens : esp�cimes
espectativas : expectativas
espertesa : esperteza
esp�sso : espesso
espetativa : expectativa
espicassar : espica�ar
espontaniedade : espontaneidade
espont�nio : espont�neo
espont�nio : espont�neo
esp�sa : esposa
esp�so : esposo
espurgar : expurgar
esquesitisse : esquisitice
esquesito : esquisito
establecer : estabelecer
estenuante : extenuante
estepor : estupor
esteporado : estuporado
estipid�s : estupidez
est�mago : est�mago
estors�o : extors�o
est�rvo : estorvo
est�rvo : estorvo
estranhesa : estranheza
estranjeirismo : estrangeirismo
estranjeiro : estrangeiro
estratejista : estrategista
estravag�ncias : extravag�ncias
estravasar : extravasar
estraviar : extraviar
estreitesa : estreiteza
estrelato : estrelado
estr�pido : estr�pito
estrovar : estorvar
estructurado : estruturado
estupurado : estuporado
esvasiar : esvaziar
et�rio : et�reo
eutan�zia : eutan�sia
evitae : evitai
exceps�o : excep��o
exceto : excepto
exdr�xula : esdr�xula
exdr�xulas : esdr�xulas
eximio : ex�mio
exitar : hesitar
exito : hesito
expecialmente : especialmente
expesso : espesso
expl�ndido : espl�ndido
explendor : esplendor
expont�neo : espont�neo
Extender : Estender
extendidos : estendidas
extor��o : extors�o
extravazar : extravasar
fabolar : fabular
faboloso : fabuloso
fac-simile : fac-s�mile
fachina : faxina
faisca : fa�sca
fa�scar : faiscar
falariam-nos : falar-nos-iam
fal�steis : falastes
far�a : farsa
far�a-mos : far�amos
farramenta : ferramenta
faser : fazer
faz�-lo-ias : f�-lo-ias
fazer-se-� : far-se-�
fazer-se-�o : far-se-�o
femenilidade : feminilidade
f�mur : f�mur
femural : femoral
ferr�gem : ferrugem
ferrujem : ferrugem
fertilisar : fertilizar
f�-lo : fi-lo
fiabelidade : fiabilidade
fiablidade : fiabilidade
finaflor : fina-flor
fiqueim : fiquem
fiscalisa��o : fiscaliza��o
fiscalisar : fiscalizar
f�sicos-qu�micos : f�sico-qu�micos
fisilogia : fisiologia
fiz-lo : fi-lo
fizes-te : fizeste
flu�dez : fluidez
fl�idez : fluidez
fluidico : flu�dico
flu�do : fluido
fogu�te : foguete
f�r : for
f�ra : fora
f�r�a : for�a
f�rem : forem
formusura : formosura
f�ro : foro
fortivo : furtivo
forum : f�rum
foruns : f�runs
fosforecente : fosforescente
fransido : franzido
fransir : franzir
fraquesa : fraqueza
frenezi : frenesi
frenezim : frenesim
freza : fresa
frezadora : fresadora
friza : frisa
frizar : frisar
frizo : friso
frustat�rio : frustrat�rio
fugire : fugir
furmosura : formosura
furmusura : formosura
furtuito : fortuito
furtunas : fortunas
gabardine : gabardina
galin�cio : galin�ceo
gasela : gazela
gasua : gazua
gazeado : gaseado
geito : jeito
geitosa : jeitosa
g�rme : germe
germen : g�rmen
gerundio : ger�ndio
giboia : jib�ia
gib�ia : jib�ia
gib�ia : jib�ia
gimn�sio : gin�sio
giradiscos : gira-discos
gis : giz
gordoroso : gorduroso
gorgeta : gorjeta
goso : gozo
g�zo : gozo
gracil : gr�cil
gra�nha : grainha
grangear : granjear
gratu�to : gratuito
gravid�s : gravidez
gravideses : gravidezes
GRECIA : GR�CIA
gromete : grumete
grum�te : grumete
gurdoroso : gorduroso
habitoo-se : habituou-se
hainda : ainda
helimotor : heliomotor
helioporto : heliporto
hemorregia : hemorragia
heriditariedade : hereditariedade
hervan�rio : ervan�rio
hervan�rio : herban�rio
heterog�neo : heterog�neo
heterog�nias : heterog�neas
heterog�nio : heterog�neo
hexitar : hesitar
h�xito : �xito
hidrog�neo : hidrog�nio
hidrog�nio : hidrog�nio
hieroglifos : hier�glifos
higi�ne : higiene
hijiene : higiene
hilariedade : hilaridade
hiper-sensibilidade : hipersensibilidade
hipnotisa��o : hipnotiza��o
hipnotisado : hipnotizado
hipnotisador : hipnotizador
hipnotisar : hipnotizar
hipnoze : hipnose
hipodromo : hip�dromo
hiredit�rio : heredit�rio
holand�ses : holandeses
homo-sexualidade : homossexualidade
homog�neo : homog�neo
homog�nio : homog�neo
homogenizar : homogeneizar
horisonte : horizonte
h�stil : hostil
hovesse : houvesse
�am : iam
iamos : �amos
�as : ias
�bero : ibero
idealogia : ideologia
idenpotente : idempotente
identica : id�ntica
idoniedade : idoneidade
ieis : �eis
igiene : higiene
ilhoses : ilh�s
ilucidar : elucidar
imcompleto : incompleto
imiss�o : emiss�o
imperadora : imperatriz
impertigado : empertigado
imploz�o : implos�o
implus�o : implos�o
impolsionar : impulsionar
imp�dico : impudico
impulsiunar : impulsionar
imundice : imund�cie
inabeis : in�beis
in�udito : inaudito
incer��o : inser��o
incerir : inserir
incluia : inclu�a
incluiam : inclu�am
incluido : inclu�do
inclu�ndo : incluindo
incluiram : inclu�ram
inclu�r�o : incluir�o
inclu�rdes : incluirdes
incluir�a : incluiria
inclu�ria : incluiria
inclu�rmos : incluirmos
incluisse : inclu�sse
inclu�u : incluiu
inclusiv� : inclusive
inconpleto : incompleto
incorajar : encorajar
incrostar : incrustar
incrostrada : incrustada
indiv�dua : indiv�duo
infraestrutura : infra-estrutura
Infraestrutura : Infra-estrutura
infraestruturas : infra-estruturas
ingec��es : injec��es
ingl�ses : ingleses
inglezice : inglesice
inglezisse : inglesice
inh�bil : in�bil
�nicio : in�cio
inje��o : injec��o
insers�o : inser��o
insistencia : insist�ncia
inssondaveis : insond�veis
inssurrei��o : insurrei��o
insurreiss�o : insurrei��o
inter-comunicador : intercomunicador
inter-institucionais : interinstitucionais
inter-sexual : intersexual
inter-sexualidade : intersexualidade
inter�sses : interesses
intergei��o : interjei��o
interrop��o : interrup��o
intersecsual : intersexual
intervia : intervinha
intervido : intervindo
intervisse : interviesse
interviu : interveio
intransij�ncia : intransig�ncia
intransijente : intransigente
intranzijente : intransigente
intrepor : interpor
intrevido : intervindo
intrevisto : entrevisto
intuia : intu�a
inxugar : enxugar
inxuto : enxuto
ir-mos : irmos
irrasc�vel : irasc�vel
items : itens
itener�rio : itiner�rio
jiboia : jib�ia
joia : j�ia
j�vem : jovem
j�vens : jovens
joventude : juventude
ju�so : ju�zo
juizes : ju�zes
juizo : ju�zo
junho : Junho
j�niores : juniores
juri : j�ri
Kg : kg
kilo : quilo
kil�metro : quil�metro
Km : km
ladiar : ladear
lage : laje
lagem : lajem
lambusado : lambuzado
lampe�o : lampi�o
lapis : l�pis
largato : lagarto
Latinoamericano : Latino-americano
l�-la : l�-la
les�ria : lez�ria
letivo : lectivo
leucocitos : leuc�citos
levesa : leveza
li�en�as : licen�as
licensas : licen�as
licensiado : licenciado
liche : lixe
ligeiresa : ligeireza
lijeireza : ligeireza
lijeiro : ligeiro
limpesa : limpeza
lingu�sta : linguista
linguistica : lingu�stica
linxado : linchado
l�gicamente : logicamente
logotipo : log�tipo
logutipo : log�tipo
l�mbago : lumbago
lunbago : lumbago
l�polo : l�pulo
lusitaneidade : lusitanidade
lusitaniedade : lusitanidade
ma�agista : massagista
macissos : maci�os
madre-silva : madressilva
magestoso : majestoso
magresa : magreza
m�gua : m�goa
mal-casado : malcasado
mal-cheiroso : malcheiroso
mal-contente : malcontente
mal-criado : malcriado
mal-feito : malfeito
mal-me-quer : malmequer
mal-nascido : malnascido
mal-visto : malvisto
malavisado : mal-avisado
malencarado : mal-encarado
malentendidos : mal-entendidos
malidic�ncias : maledic�ncias
mamarraxo : mamarracho
mangan�s : mangan�s
mangerico : manjerico
mantem-se : mant�m-se
manti-me : mantive-me
Mariza : Marisa
marm�rico : marm�reo
marm�rio : marm�reo
martirisar : martirizar
matris : matriz
mausoleu : mausol�u
mecher : mexer
mecher-lhe : mexer-lhe
m�dica-cir�rgica : m�dico-cir�rgica
m�dicos-cir�rgicos : m�dico-cir�rgicos
mediocre : med�ocre
medium : m�dium
mediuns : m�diuns
memorandu : memorando
menistro : ministro
mens�o : men��o
mensionar : mencionar
mercieiro : merceeiro
meret�ssimo : merit�ssimo
meseric�rdia : miseric�rdia
m�ta : meta
m�ta : meta
meteriologia : meteorologia
m�tro : metro
microinform�tica : micro-inform�tica
min�mo : m�nimo
minissaia : mini-saia
miradoro : miradouro
miuda : mi�da
miudo : mi�do
mixto : misto
moiem : moem
mo�nho : moinho
m�lhos : molhos
monoc�rdia : monoc�rdica
monotunia : monotonia
m�o : moo
mormura : murmura
mormurar : murmurar
mostr�o : mostram
mostreios : mostrei-os
mu� : mo�
mulhado : molhado
multim-media : multim�dia
municioso : minucioso
munotonia : monotonia
muribundo : moribundo
mussulmano : mu�ulmano
mustrar : mostrar
neo-latino : neolatino
neuro-ps�quico : neurops�quico
nitrog�neo : nitrog�nio
nitrog�nio : nitrog�nio
nobresa : nobreza
norueste : noroeste
notabiliza��o : notabilidade
n�vel : novel
nuno : Nuno
n�vem : nuvem
obce��o : obsess�o
obcess�o : obsess�o
obcessivo : obsessivo
obececar : obcecar
obetenho : obtenho
obezidade : obesidade
obj�ctivo : objectivo
Objetos : Objectos
obrigatoriadade : obrigatoriedade
obseca��o : obceca��o
obsecado : obcecado
obse��o : obsess�o
obsecar : obcecar
obsecass�o : obceca��o
obseletos : obsoletos
obsequia : obsequeia
obsuletos : obsoletos
obzequiar : obsequiar
�ca : oca
�co : oco
ocurrer : ocorrer
odia : odeia
odie : odeie
odiem : odeiem
ogemose : osmose
olfativo : olfactivo
oliar : olear
�lio : �leo
omi�o : omisso
onanimista : unanimista
openi�o : opini�o
�pinar : opinar
op�r : opor
organisa��o : organiza��o
organisar : organizar
org�os : �rg�os
or�gem : origem
ostrassismo : ostracismo
�timo : �ptimo
ourina : urina
ourinar : urinar
ourinol : urinol
outubro : Outubro
ouv�-lo : ouvi-lo
oxila��es : oscila��es
paci�nsia : paci�ncia
pagem : pajem
paizagem : paisagem
pandega : p�ndega
p�ndigo : p�ndego
paposseco : papo-seco
para-choques : p�ra-choques
parachoques : p�ra-choques
paraliza��o : paralisa��o
paralizar : paralisar
paraquedas : p�ra-quedas
pararraios : p�ra-raios
parteleira : prateleira
parvoice : parvo�ce
passeo : passeio
passiar : passear
passiei : passeei
passiemos : passeemos
passi�ncia : paci�ncia
p�teo : p�tio
patrim�nio : patrim�nio
pchisbeque : pechisbeque
p�cego : p�ssego
p�che : peixe
peco�ria : pecu�ria
ped�-la-ei : pedi-la-ei
p�ga : pega
p�ga : pega
p�gada : pegada
peiche : peixe
penalisante : penalizante
pendoricalho : penduricalho
penduresa : pendureza
penecilina : penicilina
penincilina : penicilina
pequen�s : pequenez
pera : p�ra
p�ras : peras
perceisamente : precisamente
perceito : preceito
perceptorado : preceptorado
perclaro : preclaro
perconizar : preconizar
percu�ria : pecu�ria
p�rda : perda
perdominar : predominar
perduar : perdoar
perduou : perdoou
perferivel : prefer�vel
periodo : per�odo
perju�zo : preju�zo
permissa : premissa
perp�cio : prep�cio
persagiam : pressagiam
persentido : pressentido
perspetiva : perspectiva
persta��es : presta��es
persuaz�o : persuas�o
pertens�o : pretens�o
perver��o : pervers�o
pesarozo : pesaroso
pesc��o : pesco�o
p�so : peso
pesso : pe�o
petisa : petiza
petr�lio : petr�leo
p�xe : peixe
pezadelo : pesadelo
pezar : pesar
pezaroso : pesaroso
pictoresco : pinturesco
pil�to : piloto
pil�tos : pilotos
pintoresco : pinturesco
pique-nique : piquenique
piquena : pequena
pirezinho : piresinho
piroupo : piropo
pituresco : pitoresco
piugada : peugada
plat�ia : plateia
pleiade : pl�iade
po-lo : p�-lo
pobresa : pobreza
pobresinho : pobrezinho
poco : pouco
p�co : pouco
podera : pudera
poderam : puderam
poderia-me : poder-me-ia
podessemos : pud�ssemos
poem : p�em
p�em : p�em
po�ticos-liter�rios : po�tico-liter�rios
polas : pulas
polig�mia : poligamia
politecnico : polit�cnico
ponteagudo : pontiagudo
porlongar : prolongar
porlongue : prolongue
portec��o : protec��o
portugues : portugu�s
portugu�sa : portuguesa
portugu�smente : portuguesmente
porvid�ncia : provid�ncia
pos : p�s
poseres : puseres
posescolar : p�s-escolar
posesses : pusesses
posglaci�rio : p�s-glaci�rio
posoperat�rio : p�s-operat�rio
possiblidade : possibilidade
possiveis : poss�veis
possivel : poss�vel
potuguezismo : portuguesismo
p�z-se : p�s-se
pozes : poses
poz�sseis : pus�sseis
poz�ssemos : pus�ssemos
pozinhos : posinhos
pr� : pr�
precal�o : percal�o
preceitoar : preceituar
preceveran�a : perseveran�a
precizar : precisar
preconisar : preconizar
predidos : perdidos
predum�nio : predom�nio
prefazer : perfazer
preju�so : preju�zo
prejuizo : preju�zo
premear : premiar
pr�meo : pr�mio
premiss�o : permiss�o
prenc�pio : princ�pio
prenh�s : prenhez
preplexidade : perplexidade
preplexo : perplexo
prescruta��o : perscruta��o
prescrutador : perscrutador
prespectiva : perspectiva
pressajiar : pressagiar
presserverar : perseverar
presseveran�a : perseveran�a
prestass�es : presta��es
presuas�o : persuas�o
preten��o : pretens�o
pretencioso : pretensioso
pretesto : pretexto
prevers�o : pervers�o
preversidade : perversidade
preverso : perverso
preverter : perverter
previl�gio : privil�gio
prezumido : presumido
prezun��o : presun��o
primasia : primazia
pr�ncepe : pr�ncipe
principe : pr�ncipe
priveligiado : privilegiado
probolemas : problemas
procheneta : proxeneta
productos : produtos
profundesa : profundeza
progre��o : progress�o
projeto : projecto
projetos : projectos
promenor : pormenor
promenores : pormenores
propraga��o : propaga��o
propridade : propriedade
proroga��o : prorroga��o
prorogado : prorrogado
prorogar : prorrogar
prorrugar : prorrogar
prossessador : processador
protextar : protestar
protexto : protesto
prototipo : prot�tipo
provalvelmente : provavelmente
proventura : porventura
prov�ssemos : prov�ssemos
providenci�-lo : providenci�-lo
PROVINIENTE : PROVENIENTE
provinientes : provenientes
pruibido : proibido
psico-social : psicossocial
psico-som�tico : psicossom�tico
p�-la : pu-la
p�-lo : pu-lo
puder� : poder�
pulido : polido
pulimos : polimos
pulmunar : pulmonar
puresa : pureza
puz : pus
puzemos : pusemos
puzera : pusera
puzeram : puseram
puzeras : puseras
puzeres : puseres
puzermos : pusermos
puzesse : pusesse
puzesses : pusesses
puzeste : puseste
pxisbeque : pechisbeque
quartas-feiras : Quartas-feiras
queiremos : queiramos
quer-o : quere-o
quere : quer
quere-me : quer-me
quere-se : quer-se
quer�mo-lo : queremo-lo
qu�-lo : qui-lo
qui�a : qui��
qu�s : quis
quis-lo : qui-lo
quisere : quiser
quis�steis : quisestes
quiss� : qui��
quiz : quis
quizemos : quisemos
quizer : quiser
quizera : quisera
quizeram : quiseram
quiz�ramos : quis�ramos
quizeras : quiseras
quizerdes : quiserdes
quizerem : quiserem
quizeres : quiseres
quizesse : quisesse
quizessem : quisessem
quizeste : quiseste
quiz�steis : quisestes
rabuge : rabuje
rabujento : rabugento
rabujice : rabugice
rabuscada : rebuscada
r�dio-amador : radioamador
ra�nha : rainha
ra�z : raiz
rangir : ranger
rapasinho : rapazinho
r�pidamente : rapidamente
rasia : razia
raza : rasa
razo : raso
reajir : reagir
recaiem : recaem
recentimento : ressentimento
recentir : ressentir
recepiente : recipiente
rectroactivas : retroactivas
rectroactivo : retroactivo
rectroactivos : retroactivos
redatorial : redactorial
redijir : redigir
redol : Redol
reeinstalar : reinstalar
refelex�o : reflex�o
refer-se : refere-se
referirnos-emos : referir-nos-emos
refletir : reflectir
regei��o : rejei��o
regeitar : rejeitar
r�go : rego
regorgitar : regurgitar
reincarnar : reencarnar
reinvidica��es : reivindica��es
reinvidicar : reivindicar
rejeiss�o : rejei��o
rejisto : registo
rejovenescer : rejuvenescer
rejovenescimento : rejuvenescimento
relac��o : rela��o
relaccionados : relacionados
remedia : remedeia
remedio : remedeio
repucho : repuxo
repurt�rio : repert�rio
requere : requer
requere-se : requer-se
requesitos : requisitos
resgistados : registados
resplandesc�ncia : resplandec�ncia
resplandescente : resplandecente
ressaiem : ressaem
ressurjir : ressurgir
ressurreiss�o : ressurrei��o
r�stea : r�stia
restricto : restrito
restrinjir : restringir
reteu : reteve
reto : recto
reunes : re�nes
re�nir : reunir
reuno : re�no
rezina : resina
riagir : reagir
rid�colo : rid�culo
ringi : rangi
ringido : rangido
riquesa : riqueza
rob�ula : rub�ola
rolissa : roli�a
rolisso : roli�o
roptura : ruptura
rouxinois : rouxin�is
roxinol : rouxinol
r�brica : rubrica
ru� : ro�
ruido : ru�do
ruimente : ruimmente
sacrilegadamente : acrilegamente
saida : a�da
saiem : aem
saimos : a�mos
sa�ndo : aindo
sa�r : air
saira : a�ra
sa�r� : air�
sairam : a�ram
sa�r�o : air�o
sa�r�s : air�s
sa�rdes : airdes
sairem : a�rem
sa�remos : airemos
saires : a�res
sa�rmos : airmos
sa�u : aiu
salganhada : algalhada
saliba : aliva
salvaguadar : alvaguardar
saracotiar : aracotear
s�udade : audade
saude : a�de
sear : cear
secrestar : equestrar
secresto : equestro
secretar�a : ecretaria
segnificado : ignificado
seia : ceia
Sele��o : Selec��o
selecionar : eleccionar
selinidade : enilidade
selvajamente : elvaticamente
selvajem : elvagem
selvajeria : elvageria
semi-anual : emianual
semi-cerrado : emicerrado
semi-circular : emicircular
semi-eixo : emieixo
semi-oficioso : emioficioso
semi-vogal : emivogal
semihomem : emi-homem
semiinconsciente : emi-inconsciente
semirrei : emi-rei
semiss�bio : emi-s�bio
semisselvagem : emi-selvagem
sen�ura : censura
sensura : censura
sensuras : censuras
sera : cera
s�ra : cera
seram : er�o
sereal : cereal
ser�am : eriam
serimonioso : cerimonioso
serzir : cerzir
setim : cetim
setor : ector
setores : ectores
Sexta-Feira : Sexta-feira
sextas-feiras : Sextas-feiras
sifl�tico : ifil�tico
simbolo : �mbolo
sinosite : inusite
sintasse : intaxe
sint�tico : int�ctico
sintonisar : intonizar
sinuzite : inusite
s�be : oube
sobrecelente : obresselente
sobrehumano : obre-humano
sobridade : obriedade
socegado : ossegado
socegar : ossegar
socego : ossego
sociadade : ociedade
so�ubrar : o�obrar
socumbir : ucumbir
sodeste : udeste
sodueste : udoeste
s�mente : omente
son�mbolo : on�mbulo
sorjo : urjo
sorrizinho : orrisinho
sorv�te : orvete
sosinho : ozinho
sossobrar : o�obrar
sot�os : �t�os
sovieticos : ovi�ticos
s�zinho : ozinho
sub-delegado : ubdelegado
sub-grupo : ubgrupo
Sub-grupo : Subgrupo
sub-solos : ubsolos
subesservi�ncia : ubservi�ncia
subibliotec�rio : ub-bibliotec�rio
subito : �bito
subrepticiamente : ub-repticiamente
subrepticio : ub-rept�cio
substituia : ubstitu�a
substituitivo : ubstitutivo
substitu�u : ubstituiu
substracto : ubstrato
su�obrar : o�obrar
sujerir : ugerir
sujest�o : ugest�o
sunambulismo : onambulismo
s�per-homem : uper-homem
superhomem : uper-homem
suprassumo : upra-sumo
supre��o : upress�o
supresti��o : upersti��o
supresticioso : upersticioso
surjir : urgir
surpr�sa : urpresa
surpreza : urpresa
surrapa : zurrapa
survete : orvete
suspen��o : uspens�o
susseder : uceder
taboleiro : tabuleiro
talv�s : talvez
tambem : tamb�m
tartante : tratante
t�tica : t�ctica
t�tico : t�ctico
teem : t�m
tele-guiado : teleguiado
televizivo : televisivo
t�m : tem
tem-o : tem-no
t�nue : t�nue
t�nues : t�nues
terebentina : terebintina
terjeitos : trejeitos
terramoto : terremoto
terraplanagem : terraplenagem
terraplanar : terraplenar
terraqueo : terr�queo
terr�quio : terr�queo
t�steis : t�xteis
tetos : tectos
teurap�utico : terap�utico
texteis : t�xteis
t�xteis : t�xteis
tijela : tigela
tor�xico : tor�cico
torc�colo : torcicolo
tors�o : tor��o
torser : torcer
torsida : torcida
torsido : torcido
t�rso : torso
tot�m : totem
totens : t�temes
toxico : t�xico
tragect�ria : traject�ria
traiem : traem
traj�dia : trag�dia
trajeto : trajecto
trajet�ria : traject�ria
tr�jico : tr�gico
tranquilisador : tranquilizador
tranquilisante : tranquilizante
tr�nsido : transido
transmetir : transmitir
transmi��o : transmiss�o
transmitente : transmissor
tranze : transe
tranzido : transido
traser : trazer
traz�-lo-ei : tr�-lo-ei
traz�-lo-ia : tr�-lo-ia
trazeira : traseira
trazeiro : traseiro
trazer-nos-ia : trar-nos-ia
trazer-se-� : trar-se-�
trazer-se-�o : trar-se-�o
tregeitos : trejeitos
tres : tr�s
trez : tr�s
tri-campe�o : tricampe�o
tricampi� : tricampe�
trilingue : tril�ngue
tristesa : tristeza
tr�co : troco
trousse : trouxe
troussestes : trouxestes
tunel : t�nel
turc�colo : torcicolo
ultra-violeta : ultravioleta
�mido : h�mido
un�ssuno : un�ssono
urano : ur�nio
utilisar : utilizar
utlizadores : utilizadores
v�cum : vacum
vag�os : vag�es
vasio : vazio
v� : v�
veiculo : ve�culo
veinculado : veiculado
v�m : vem
v�rbo : verbo
v�rbo : verbo
veredito : veredicto
veria��o : verea��o
veriador : vereador
vert�gem : vertigem
vert�gens : vertigens
veses : vezes
veu : v�u
vi�steis : viestes
vintem : vint�m
v�rgem : virgem
visinhan�a : vizinhan�a
visinho : vizinho
viuva : vi�va
viuv�s : viuvez
vi�vez : viuvez
viuvo : vi�vo
viva�o : vivaz
vivasso : vivaz
viz�o : vis�o
vizar : visar
vizita : visita
vizitante : visitante
viz�vel : vis�vel
vizualisar : visualizar
vizualizar : visualizar
vocemess� : vossemec�
vo� : voou
v�o : voo
voses : vozes
vossemess� : vossemec�
vozeria : vozearia
vu� : voou
vuou : voou
xadresista : xadrezista
xal : xale
xalupa : chalupa
x�vena : ch�vena
x�x� : xex�
xixi : chichi
xucha : chucha
xuxa : chucha
zenite : z�nite
zig-zag : ziguezague
� : �
�rvore : �rvore
abanbonar : abandonar
acessas : acesas
actividadees : actividades
Administar��o : Administra��o
Agosot : Agosto
alg�m : algu�m
algorimto : algoritmo
amplamante : amplamente
aolgoritmos : algoritmos
aproxiam��o : aproxima��o
arrajemos : arranjemos
avivizinham : avizinham
Barsil : Brasil
Bibliteca : Biblioteca
Bilioteca : Biblioteca
bolachinas : bolachinhas
brincadira : brincadeira
Camarados : Camaradas
candiadatos : candidatos
candiadaturas : candidaturas
candiadturas : candidaturas
caracteriscas : caracter�sticas
cedererem : cederem
Chesfes : Chefes
cinetificas : cient�ficas
cobe : coube
comec� : come�a
computadres : computadores
comtempla : contempla
conguir : conseguir
constitudo : constitu�do
Contacos : Contactos
contrbuir : contribuir
contrpartida : contrapartida
contunar : continuar
contunar : continuar
correpondencia : correspond�ncia
corres-pond�ncia : correspond�ncia
correspondecia : correspond�ncia
correspondenccia : correspond�ncia
cultuarais : culturais
demaais : demais
demonstar��es : demonstra��es
desenvimento : desenvolvimento
desenvovimento : desenvolvimento
desulpem : desculpem
dificukdades : dificuldades
diger : dizer
Direcc��o : Direc��o
discus�o : discuss�o
disses : disse
divlugue : divulgue
divugar : divulgar
domnos : donos
doutirado : doutorado
dsenvolvimento : desenvolvimento
eatarem : estarem
econtra : encontra
ecosistemas : ecossistemas
eferendo : referendo
Efificio : Edif�cio
elega��o : delega��o
emnos : menos
enconbtra : encontra
ENCONTA-SE : ENCONTRA-SE
ENCONTAM-SE : ENCONTRAM-SE
encontar : encontrar
Epediente : Expediente
escever : escrever
espirrito : esp�rito
esssa : essa
establecer : estabelecer
estajam : estejam
estass : estas
exeplares : exemplares
exist�mcia : exist�ncia
exitencia : exist�ncia
experiancia : experi�ncia
Extrordinaria : Extraordin�ria
favor�aveis : favor�veis
fazere : fazer
fiabiliade : fiabilidade
fianciamento : financiamento
fidalgias : fidalguias
flutuaa��es : flutua��es
fomato : formato
frustados : frustrados
gabinte : gabinete
garatir : garantir
graande : grande
Homesns : Homens
idea : ideia
ideiua : ideia
imeditamente : imediatamente
implemenetam : implementam
impossival : imposs�vel
imputads : imputados
inauguardo : inaugurado
inciar : iniciar
inciativas : iniciativas
incrito : inscrito
Indistrial : Industrial
indiviseis : indivis�veis
indivuduais : individuais
infoma��es : informa��es
inforam��o : informa��o
informmatica : inform�tica
inscever-se : inscrever-se
instituo��o : institui��o
institutoas : institutos
interesado : interessado
interesados : interessados
interesante : interessante
interssado : interessado
Intitui��es : Institui��es
investig��o : investiga��o
iscuss�o : discuss�o
isoladamnete : isoladamente
itesm : itens
la�amento : lan�amento
leventado : levantado
liagassem : ligassem
libera��o : liberta��o
licancas : licen�as
licenciatua : licenciatura
LUMIMOSA : LUMINOSA
malata : malta
mandase : mandasse
mandassess : mandasses
mebros : membros
memso : mesmo
mewses : meses
mis'erios  mist�rios : t
momemto : momento
Multmedia : Multim�dia
mundan�a : mudan�a
muuito : muito
n�o : n�o
naao : n�o
nais : mais
natale : natal
necesitar : necessitar
necess�io : necess�rio
nemhuma : nenhuma
nomeadamentem : nomeadamente
nomeadamento : nomeadamente
nomedamente : nomeadamente
numca : nunca
nuneros : n�meros
oferecen : oferecem
optimisitico : optim�stico
organigrams : organigramas
orginador : originador
ortigr�fica : ortogr�fica
ortigr�fico : ortogr�fico
ourtra : outra
panhado : apanhado
part�pio : partic�pio
partica : pratica
partilihar : partilhar
pekla : pela
perceisamente : precisamente
perguntaou : perguntou
persectivas : perspectivas
pesssoa : pessoa
pesssoal : pessoal
podera : poder�
podiamo : pod�amos
podria : poderia
porgrama : programa
poss-te : posso-te
posss�vel : poss�vel
possso : posso
postall : postal
pprimeiras : primeiras
prblemas : problemas
preceso : preciso
previsvel : previs�vel
princio : princ�pio
probelma : problema
procedimeto : procedimento
processamneto : processamento
produtivade : produtividade
profisssional : profissional
prograssos : progressos
prolemas : problemas
proposcoes : propor��es
publica�a�es : publica��es
Qando : Quando
qaulidade : qualidade
quarquer : qualquer
qui : aqui
qunto : quanto
qye : que
recional : racional
recuros : recursos
relacinado : relacionado
relaizar : realizar
repetui-se : repetiu-se
repons�veis : respons�veis
reponsavel : respons�vel
respectvos : respectivos
responsabnilidade : responsabilidade
sacricios : acrif�cios
Segeum-se : Seguem-se
segir : seguir
seguines : seguintes
selaec��o : selec��o
senytido : sentido
serai : serei
Sevi�o : Servi�o
sevi�os : servi�os
sguerras : guerras
Sgundo : Segundo
intactica : sint�ctica
itu��o : situa��o
sugest�oes : sugest�es
ta�cas : ta�as
tadu��es : tradu��es
tecnogia : tecnologia
telvez : talvez
temnho : tenho
testest : testes
tiveese : tivesse
tranporte : transporte
trentem : tentem
�ultima : �ltima
uiniversitarios : universit�rios
Unversidadese : Universidades
uperiores : uperiores
Utilizdores : Utilizadores
van�ar : avan�ar
verique : verifique
vers�o : vers�o
vers�O : vers�O
vwerificar : verificar
wais : vais
